Date,Daily Followers Gained,Total Follower Count,Daily Followed Users,Total Followed Users,Daily Tweets Posted,Total Tweets Posted,Name
2016-12-09,1832,1385792,0,10,0,1199,joebiden
2016-12-10,1209,1387001,0,10,0,1199,joebiden
2016-12-11,1331,1388332,0,10,0,1199,joebiden
2016-12-12,1038,1389370,0,10,0,1199,joebiden
2016-12-13,1231,1390601,0,10,0,1199,joebiden
2016-12-14,665,1391266,0,10,0,1199,joebiden
2016-12-15,1267,1392533,0,10,0,1199,joebiden
2016-12-16,1000,1393533,0,10,0,1199,joebiden
2016-12-17,925,1394458,0,10,0,1199,joebiden
2016-12-18,872,1395330,0,10,0,1199,joebiden
2016-12-19,1096,1396426,0,10,0,1199,joebiden
2016-12-20,1048,1397474,0,10,0,1199,joebiden
2016-12-21,915,1398389,0,10,0,1199,joebiden
2016-12-22,827,1399216,0,10,0,1199,joebiden
2016-12-23,916,1400132,0,10,0,1199,joebiden
2016-12-24,698,1400830,0,10,0,1199,joebiden
2016-12-25,837,1401667,0,10,0,1199,joebiden
2016-12-26,796,1402463,0,10,0,1199,joebiden
2016-12-27,956,1403419,0,10,0,1199,joebiden
2016-12-28,1046,1404465,0,10,0,1199,joebiden
2016-12-29,847,1405312,0,10,0,1199,joebiden
2016-12-30,847,1406159,0,10,0,1199,joebiden
2016-12-31,894,1407053,0,10,0,1199,joebiden
2017-01-01,535,1407588,0,10,0,1199,joebiden
2017-01-02,1713,1409301,0,10,0,1199,joebiden
2017-01-03,2188,1411489,0,10,0,1199,joebiden
2017-01-04,1524,1413013,0,10,0,1199,joebiden
2017-01-05,1523,1414536,0,10,0,1199,joebiden
2017-01-06,2632,1417168,0,10,0,1199,joebiden
2017-01-07,2075,1419243,0,10,0,1199,joebiden
2017-01-08,395,1419638,0,10,0,1199,joebiden
2017-01-09,259,1419897,0,10,0,1199,joebiden
2017-01-10,361,1420258,0,10,0,1199,joebiden
2017-01-11,2436,1422694,0,10,0,1199,joebiden
2017-01-12,328,1423022,0,10,0,1199,joebiden
2017-01-13,12773,1435795,0,10,0,1199,joebiden
2017-01-14,1175,1436970,0,10,0,1199,joebiden
2017-01-15,1526,1438496,0,10,0,1199,joebiden
2017-01-16,489,1438985,0,10,0,1199,joebiden
2017-01-17,1270,1440255,0,10,0,1199,joebiden
2017-01-18,7368,1447623,0,10,0,1199,joebiden
2017-01-19,3914,1451537,0,10,0,1199,joebiden
2017-01-20,29772,1481309,1,11,0,1199,joebiden
2017-01-21,29631,1510940,1,12,0,1199,joebiden
2017-01-22,6570,1517510,0,12,0,1199,joebiden
2017-01-23,5658,1523168,0,12,0,1199,joebiden
2017-01-24,2889,1526057,0,12,0,1199,joebiden
2017-01-25,2123,1528180,0,12,0,1199,joebiden
2017-01-26,2183,1530363,0,12,0,1199,joebiden
2017-01-27,1522,1531885,0,12,0,1199,joebiden
2017-01-28,1218,1533103,0,12,0,1199,joebiden
2017-01-29,2145,1535248,0,12,0,1199,joebiden
2017-01-30,2024,1537272,0,12,0,1199,joebiden
2017-01-31,1278,1538550,0,12,0,1199,joebiden
2017-02-01,2623,1541173,1,13,3,1202,joebiden
2017-02-02,8888,1550061,0,13,0,1202,joebiden
2017-02-03,8535,1558596,0,13,1,1203,joebiden
2017-02-04,7997,1566593,0,13,0,1203,joebiden
2017-02-05,6695,1573288,0,13,0,1203,joebiden
2017-02-06,19960,1593248,0,13,1,1204,joebiden
2017-02-07,7973,1601221,0,13,0,1204,joebiden
2017-02-08,8636,1609857,0,13,0,1204,joebiden
2017-02-09,9121,1618978,0,13,0,1204,joebiden
2017-02-10,8111,1627089,0,13,0,1204,joebiden
2017-02-11,4244,1631333,1,14,0,1204,joebiden
2017-02-12,3906,1635239,0,14,0,1204,joebiden
2017-02-13,3979,1639218,0,14,0,1204,joebiden
2017-02-14,3005,1642223,0,14,0,1204,joebiden
2017-02-15,6210,1648433,0,14,0,1204,joebiden
2017-02-16,3777,1652210,0,14,0,1204,joebiden
2017-02-17,3533,1655743,0,14,0,1204,joebiden
2017-02-18,2685,1658428,0,14,0,1204,joebiden
2017-02-19,2295,1660723,0,14,0,1204,joebiden
2017-02-20,2707,1663430,0,14,0,1204,joebiden
2017-02-21,2568,1665998,0,14,0,1204,joebiden
2017-02-22,2058,1668056,0,14,0,1204,joebiden
2017-02-23,1987,1670043,0,14,0,1204,joebiden
2017-02-24,2202,1672245,0,14,0,1204,joebiden
2017-02-25,1910,1674155,0,14,0,1204,joebiden
2017-02-26,4104,1678259,0,14,1,1205,joebiden
2017-02-27,2788,1681047,0,14,0,1205,joebiden
2017-02-28,1906,1682953,0,14,0,1205,joebiden
2017-03-01,2841,1685794,0,14,0,1205,joebiden
2017-03-02,2258,1688052,0,14,0,1205,joebiden
2017-03-03,2106,1690158,0,14,0,1205,joebiden
2017-03-04,1879,1692037,0,14,0,1205,joebiden
2017-03-05,2239,1694276,0,14,0,1205,joebiden
2017-03-06,1973,1696249,0,14,0,1205,joebiden
2017-03-07,2410,1698659,0,14,0,1205,joebiden
2017-03-08,2186,1700845,0,14,0,1205,joebiden
2017-03-09,2736,1703581,0,14,1,1206,joebiden
2017-03-10,1863,1705444,0,14,0,1206,joebiden
2017-03-11,1460,1706904,0,14,0,1206,joebiden
2017-03-12,1405,1708309,0,14,0,1206,joebiden
2017-03-13,2217,1710526,0,14,3,1209,joebiden
2017-03-14,1970,1712496,0,14,0,1209,joebiden
2017-03-15,2058,1714554,0,14,0,1209,joebiden
2017-03-16,2013,1716567,0,14,0,1209,joebiden
2017-03-17,2255,1718822,0,14,3,1212,joebiden
2017-03-18,2526,1721348,1,15,0,1212,joebiden
2017-03-19,1928,1723276,0,15,0,1212,joebiden
2017-03-20,2181,1725457,0,15,0,1212,joebiden
2017-03-21,2357,1727814,0,15,0,1212,joebiden
2017-03-22,2333,1730147,0,15,0,1212,joebiden
2017-03-23,3258,1733405,0,15,0,1212,joebiden
2017-03-24,7643,1741048,0,15,1,1213,joebiden
2017-03-25,5781,1746829,0,15,1,1214,joebiden
2017-03-26,2809,1749638,0,15,0,1214,joebiden
2017-03-27,2370,1752008,0,15,0,1214,joebiden
2017-03-28,1799,1753807,0,15,1,1215,joebiden
2017-03-29,3855,1757662,0,15,0,1215,joebiden
2017-03-30,2590,1760252,0,15,4,1219,joebiden
2017-03-31,1807,1762059,1,16,2,1221,joebiden
2017-04-01,1360,1763419,0,16,0,1221,joebiden
2017-04-02,1062,1764481,0,16,0,1221,joebiden
2017-04-03,1061,1765542,0,16,0,1221,joebiden
2017-04-04,1286,1766828,0,16,0,1221,joebiden
2017-04-05,1108,1767936,0,16,0,1221,joebiden
2017-04-06,1202,1769138,0,16,1,1222,joebiden
2017-04-07,1393,1770531,0,16,2,1224,joebiden
2017-04-08,1306,1771837,0,16,3,1227,joebiden
2017-04-09,869,1772706,0,16,0,1227,joebiden
2017-04-10,851,1773557,0,16,0,1227,joebiden
2017-04-11,713,1774270,0,16,0,1227,joebiden
2017-04-12,843,1775113,0,16,0,1227,joebiden
2017-04-13,613,1775726,0,16,0,1227,joebiden
2017-04-14,1158,1776884,0,16,0,1227,joebiden
2017-04-15,1848,1778732,0,16,2,1229,joebiden
2017-04-16,1186,1779918,0,16,0,1229,joebiden
2017-04-17,698,1780616,0,16,0,1229,joebiden
2017-04-18,614,1781230,0,16,1,1230,joebiden
2017-04-19,819,1782049,0,16,0,1230,joebiden
2017-04-20,885,1782934,0,16,0,1230,joebiden
2017-04-21,1306,1784240,0,16,0,1230,joebiden
2017-04-22,1278,1785518,0,16,0,1230,joebiden
2017-04-23,1298,1786816,0,16,0,1230,joebiden
2017-04-24,1411,1788227,0,16,0,1230,joebiden
2017-04-25,1471,1789698,0,16,0,1230,joebiden
2017-04-26,1146,1790844,0,16,0,1230,joebiden
2017-04-27,1822,1792666,0,16,1,1231,joebiden
2017-04-28,1314,1793980,0,16,0,1231,joebiden
2017-04-29,1113,1795093,0,16,0,1231,joebiden
2017-04-30,1135,1796228,0,16,0,1231,joebiden
2017-05-01,1242,1797470,0,16,0,1231,joebiden
2017-05-02,1079,1798549,0,16,0,1231,joebiden
2017-05-03,1221,1799770,0,16,0,1231,joebiden
2017-05-04,1341,1801111,0,16,0,1231,joebiden
2017-05-05,8140,1809251,0,16,2,1233,joebiden
2017-05-06,3892,1813143,0,16,0,1233,joebiden
2017-05-07,1264,1814407,0,16,0,1233,joebiden
2017-05-08,1705,1816112,0,16,0,1233,joebiden
2017-05-09,1222,1817334,0,16,0,1233,joebiden
2017-05-10,2173,1819507,0,16,1,1234,joebiden
2017-05-11,1872,1821379,0,16,0,1234,joebiden
2017-05-12,1336,1822715,0,16,0,1234,joebiden
2017-05-13,1428,1824143,0,16,0,1234,joebiden
2017-05-14,1244,1825387,0,16,0,1234,joebiden
2017-05-15,2072,1827459,0,16,0,1234,joebiden
2017-05-16,1938,1829397,0,16,0,1234,joebiden
2017-05-17,1944,1831341,0,16,0,1234,joebiden
2017-05-18,1855,1833196,0,16,1,1235,joebiden
2017-05-19,1347,1834543,0,16,0,1235,joebiden
2017-05-20,505,1835048,0,16,0,1235,joebiden
2017-05-21,621,1835669,0,16,0,1235,joebiden
2017-05-22,513,1836182,0,16,0,1235,joebiden
2017-05-23,777,1836959,0,16,0,1235,joebiden
2017-05-24,2348,1839307,0,16,0,1235,joebiden
2017-05-25,1863,1841170,0,16,1,1236,joebiden
2017-05-26,1885,1843055,0,16,0,1236,joebiden
2017-05-27,1697,1844752,0,16,0,1236,joebiden
2017-05-28,2472,1847224,0,16,1,1237,joebiden
2017-05-29,2319,1849543,0,16,0,1237,joebiden
2017-05-30,2381,1851924,0,16,1,1238,joebiden
2017-05-31,2143,1854067,0,16,0,1238,joebiden
2017-06-01,4129,1858196,0,16,7,1245,joebiden
2017-06-02,6492,1864688,0,16,1,1246,joebiden
2017-06-03,2620,1867308,0,16,0,1246,joebiden
2017-06-04,2103,1869411,0,16,1,1247,joebiden
2017-06-05,2009,1871420,0,16,0,1247,joebiden
2017-06-06,1665,1873085,0,16,0,1247,joebiden
2017-06-07,1704,1874789,0,16,1,1248,joebiden
2017-06-08,1895,1876684,0,16,1,1249,joebiden
2017-06-09,1978,1878662,0,16,0,1249,joebiden
2017-06-10,1374,1880036,0,16,0,1249,joebiden
2017-06-11,1228,1881264,0,16,0,1249,joebiden
2017-06-12,1489,1882753,0,16,0,1249,joebiden
2017-06-13,1540,1884293,0,16,1,1250,joebiden
2017-06-14,2096,1886389,0,16,0,1250,joebiden
2017-06-15,1725,1888114,0,16,1,1251,joebiden
2017-06-16,1621,1889735,0,16,1,1252,joebiden
2017-06-17,1935,1891670,0,16,0,1252,joebiden
2017-06-18,1857,1893527,0,16,1,1253,joebiden
2017-06-19,3099,1896626,0,16,0,1253,joebiden
2017-06-20,2519,1899145,0,16,0,1253,joebiden
2017-06-21,2205,1901350,1,17,1,1254,joebiden
2017-06-22,2095,1903445,0,17,0,1254,joebiden
2017-06-23,2750,1906195,0,17,0,1254,joebiden
2017-06-24,3725,1909920,0,17,4,1258,joebiden
2017-06-25,2858,1912778,0,17,0,1258,joebiden
2017-06-26,2333,1915111,0,17,0,1258,joebiden
2017-06-27,2494,1917605,0,17,2,1260,joebiden
2017-06-28,2200,1919805,0,17,0,1260,joebiden
2017-06-29,2469,1922274,0,17,0,1260,joebiden
2017-06-30,2599,1924873,0,17,0,1260,joebiden
2017-07-01,1952,1926825,0,17,0,1260,joebiden
2017-07-02,1716,1928541,0,17,0,1260,joebiden
2017-07-03,1910,1930451,0,17,0,1260,joebiden
2017-07-04,1822,1932273,0,17,0,1260,joebiden
2017-07-05,2133,1934406,0,17,1,1261,joebiden
2017-07-06,1899,1936305,0,17,0,1261,joebiden
2017-07-07,1559,1937864,0,17,0,1261,joebiden
2017-07-08,2602,1940466,0,17,0,1261,joebiden
2017-07-09,2221,1942687,0,17,0,1261,joebiden
2017-07-10,2820,1945507,0,17,0,1261,joebiden
2017-07-11,4245,1949752,0,17,0,1261,joebiden
2017-07-12,3274,1953026,0,17,1,1262,joebiden
2017-07-13,3143,1956169,0,17,0,1262,joebiden
2017-07-14,2436,1958605,0,17,0,1262,joebiden
2017-07-15,2442,1961047,0,17,0,1262,joebiden
2017-07-16,2489,1963536,0,17,0,1262,joebiden
2017-07-17,2620,1966156,0,17,1,1263,joebiden
2017-07-18,2990,1969146,0,17,7,1270,joebiden
2017-07-19,2319,1971465,0,17,0,1270,joebiden
2017-07-20,7520,1978985,0,17,2,1272,joebiden
2017-07-21,4624,1983609,1,18,0,1272,joebiden
2017-07-22,2858,1986467,0,18,0,1272,joebiden
2017-07-23,2388,1988855,0,18,0,1272,joebiden
2017-07-24,2204,1991059,0,18,0,1272,joebiden
2017-07-25,2176,1993235,0,18,1,1273,joebiden
2017-07-26,5756,1998991,0,18,1,1274,joebiden
2017-07-27,26731,2025722,0,18,2,1276,joebiden
2017-07-28,5985,2031707,0,18,1,1277,joebiden
2017-07-29,4349,2036056,0,18,1,1278,joebiden
2017-07-30,3316,2039372,0,18,0,1278,joebiden
2017-07-31,2606,2041978,0,18,0,1278,joebiden
2017-08-01,2309,2044287,0,18,1,1279,joebiden
2017-08-02,2341,2046628,0,18,0,1279,joebiden
2017-08-03,2140,2048768,0,18,0,1279,joebiden
2017-08-04,2909,2051677,0,18,1,1280,joebiden
2017-08-05,11807,2063484,0,18,0,1280,joebiden
2017-08-06,3132,2066616,0,18,0,1280,joebiden
2017-08-07,1416,2068032,0,18,0,1280,joebiden
2017-08-08,1792,2069824,0,18,0,1280,joebiden
2017-08-09,2591,2072415,0,18,0,1280,joebiden
2017-08-10,3082,2075497,0,18,0,1280,joebiden
2017-08-11,3452,2078949,0,18,0,1280,joebiden
2017-08-12,2998,2081947,0,18,0,1280,joebiden
2017-08-13,30975,2112922,0,18,2,1282,joebiden
2017-08-14,14185,2127107,0,18,0,1282,joebiden
2017-08-15,6210,2133317,0,18,0,1282,joebiden
2017-08-16,9897,2143214,0,18,0,1282,joebiden
2017-08-17,8128,2151342,0,18,0,1282,joebiden
2017-08-18,6123,2157465,0,18,1,1283,joebiden
2017-08-19,4934,2162399,0,18,0,1283,joebiden
2017-08-20,4305,2166704,0,18,0,1283,joebiden
2017-08-21,3477,2170181,0,18,0,1283,joebiden
2017-08-22,3521,2173702,0,18,0,1283,joebiden
2017-08-23,3929,2177631,0,18,0,1283,joebiden
2017-08-24,3980,2181611,0,18,1,1284,joebiden
2017-08-25,4057,2185668,0,18,0,1284,joebiden
2017-08-26,3584,2189252,0,18,0,1284,joebiden
2017-08-27,4512,2193764,0,18,0,1284,joebiden
2017-08-28,6824,2200588,0,18,1,1285,joebiden
2017-08-29,4467,2205055,0,18,0,1285,joebiden
2017-08-30,3264,2208319,0,18,0,1285,joebiden
2017-08-31,3302,2211621,0,18,0,1285,joebiden
2017-09-01,1861,2213482,0,18,0,1285,joebiden
2017-09-02,1623,2215105,0,18,0,1285,joebiden
2017-09-03,1731,2216836,0,18,0,1285,joebiden
2017-09-04,1817,2218653,0,18,0,1285,joebiden
2017-09-05,1876,2220529,0,18,0,1285,joebiden
2017-09-06,14836,2235365,0,18,1,1286,joebiden
2017-09-07,5047,2240412,0,18,0,1286,joebiden
2017-09-08,2778,2243190,0,18,1,1287,joebiden
2017-09-09,2616,2245806,0,18,0,1287,joebiden
2017-09-10,2592,2248398,0,18,1,1288,joebiden
2017-09-11,2468,2250866,0,18,1,1289,joebiden
2017-09-12,3018,2253884,0,18,0,1289,joebiden
2017-09-13,2600,2256484,0,18,0,1289,joebiden
2017-09-14,3189,2259673,0,18,1,1290,joebiden
2017-09-15,2368,2262041,0,18,1,1291,joebiden
2017-09-16,1950,2263991,0,18,0,1291,joebiden
2017-09-17,1864,2265855,0,18,0,1291,joebiden
2017-09-18,1947,2267802,0,18,2,1293,joebiden
2017-09-19,8765,2276567,0,18,2,1295,joebiden
2017-09-20,4909,2281476,0,18,1,1296,joebiden
2017-09-21,3403,2284879,0,18,3,1299,joebiden
2017-09-22,1970,2286849,0,18,0,1299,joebiden
2017-09-23,2110,2288959,0,18,1,1300,joebiden
2017-09-24,2640,2291599,0,18,0,1300,joebiden
2017-09-25,2536,2294135,0,18,0,1300,joebiden
2017-09-26,8689,2302824,0,18,2,1302,joebiden
2017-09-27,4257,2307081,0,18,0,1302,joebiden
2017-09-28,4029,2311110,0,18,1,1303,joebiden
2017-09-29,13209,2324319,0,18,3,1306,joebiden
2017-09-30,8195,2332514,1,19,2,1308,joebiden
2017-10-01,4462,2336976,0,19,0,1308,joebiden
2017-10-02,5930,2342906,0,19,2,1310,joebiden
2017-10-03,6947,2349853,0,19,1,1311,joebiden
2017-10-04,5747,2355600,0,19,2,1313,joebiden
2017-10-05,3996,2359596,0,19,1,1314,joebiden
2017-10-06,3370,2362966,0,19,1,1315,joebiden
2017-10-07,3479,2366445,0,19,0,1315,joebiden
2017-10-08,3433,2369878,0,19,0,1315,joebiden
2017-10-09,3665,2373543,0,19,0,1315,joebiden
2017-10-10,3625,2377168,0,19,0,1315,joebiden
2017-10-11,3540,2380708,0,19,0,1315,joebiden
2017-10-12,3704,2384412,0,19,0,1315,joebiden
2017-10-13,3032,2387444,1,20,2,1317,joebiden
2017-10-14,3142,2390586,0,20,1,1318,joebiden
2017-10-15,2790,2393376,0,20,0,1318,joebiden
2017-10-16,2624,2396000,0,20,0,1318,joebiden
2017-10-17,4259,2400259,0,20,5,1323,joebiden
2017-10-18,4136,2404395,0,20,1,1324,joebiden
2017-10-19,2518,2406913,0,20,0,1324,joebiden
2017-10-20,2824,2409737,0,20,0,1324,joebiden
2017-10-21,2575,2412312,0,20,-1,1323,joebiden
2017-10-22,2720,2415032,0,20,0,1323,joebiden
2017-10-23,2650,2417682,1,21,1,1324,joebiden
2017-10-24,2817,2420499,0,21,1,1325,joebiden
2017-10-25,7641,2428140,0,21,1,1326,joebiden
2017-10-26,566,2428706,1,22,1,1327,joebiden
2017-10-27,2213,2430919,0,22,0,1327,joebiden
2017-10-28,1840,2432759,0,22,0,1327,joebiden
2017-10-29,2399,2435158,0,22,0,1327,joebiden
2017-10-30,2779,2437937,0,22,0,1327,joebiden
2017-10-31,3538,2441475,0,22,0,1327,joebiden
2017-11-01,2918,2444393,0,22,3,1330,joebiden
2017-11-02,8544,2452937,0,22,0,1330,joebiden
2017-11-03,1131,2454068,0,22,0,1330,joebiden
2017-11-04,2830,2456898,0,22,0,1330,joebiden
2017-11-05,2052,2458950,0,22,0,1330,joebiden
2017-11-06,3018,2461968,0,22,2,1332,joebiden
2017-11-07,2701,2464669,0,22,1,1333,joebiden
2017-11-08,5240,2469909,0,22,5,1338,joebiden
2017-11-09,6039,2475948,0,22,1,1339,joebiden
2017-11-10,979,2476927,0,22,0,1339,joebiden
2017-11-11,1109,2478036,0,22,0,1339,joebiden
2017-11-12,1259,2479295,0,22,2,1341,joebiden
2017-11-13,2315,2481610,0,22,0,1341,joebiden
2017-11-14,2186,2483796,0,22,0,1341,joebiden
2017-11-15,1741,2485537,0,22,0,1341,joebiden
2017-11-16,3834,2489371,0,22,0,1341,joebiden
2017-11-17,2224,2491595,0,22,0,1341,joebiden
2017-11-18,2070,2493665,0,22,0,1341,joebiden
2017-11-19,2091,2495756,0,22,0,1341,joebiden
2017-11-20,2455,2498211,0,22,0,1341,joebiden
2017-11-21,15765,2513976,0,22,0,1341,joebiden
2017-11-22,5965,2519941,0,22,0,1341,joebiden
2017-11-23,3110,2523051,0,22,1,1342,joebiden
2017-11-24,2623,2525674,0,22,0,1342,joebiden
2017-11-25,2521,2528195,0,22,0,1342,joebiden
2017-11-26,1734,2529929,0,22,1,1343,joebiden
2017-11-27,1142,2531071,0,22,0,1343,joebiden
2017-11-28,1672,2532743,0,22,0,1343,joebiden
2017-11-29,1706,2534449,0,22,0,1343,joebiden
2017-11-30,1691,2536140,0,22,3,1346,joebiden
2017-12-01,1400,2537540,0,22,2,1348,joebiden
2017-12-02,2534,2540074,0,22,1,1349,joebiden
2017-12-03,3876,2543950,0,22,0,1349,joebiden
2017-12-04,1507,2545457,0,22,0,1349,joebiden
2017-12-05,1474,2546931,0,22,1,1350,joebiden
2017-12-06,1614,2548545,0,22,0,1350,joebiden
2017-12-07,1623,2550168,0,22,2,1352,joebiden
2017-12-08,1272,2551440,0,22,0,1352,joebiden
2017-12-09,1037,2552477,0,22,0,1352,joebiden
2017-12-10,1572,2554049,0,22,0,1352,joebiden
2017-12-11,1646,2555695,0,22,1,1353,joebiden
2017-12-12,1187,2556882,0,22,2,1355,joebiden
2017-12-13,8077,2564959,0,22,1,1356,joebiden
2017-12-14,10211,2575170,0,22,3,1359,joebiden
2017-12-15,1733,2576903,0,22,0,1359,joebiden
2017-12-16,1860,2578763,0,22,0,1359,joebiden
2017-12-17,616,2579379,0,22,0,1359,joebiden
2017-12-18,1318,2580697,0,22,0,1359,joebiden
2017-12-19,1128,2581825,0,22,0,1359,joebiden
2017-12-20,1574,2583399,0,22,0,1359,joebiden
2017-12-21,2400,2585799,0,22,0,1359,joebiden
2017-12-22,1805,2587604,0,22,0,1359,joebiden
2017-12-23,1559,2589163,0,22,0,1359,joebiden
2017-12-24,1560,2590723,0,22,0,1359,joebiden
2017-12-25,2008,2592731,0,22,1,1360,joebiden
2017-12-26,2173,2594904,0,22,0,1360,joebiden
2017-12-27,2080,2596984,0,22,0,1360,joebiden
2017-12-28,2993,2599977,0,22,0,1360,joebiden
2017-12-29,2321,2602298,0,22,0,1360,joebiden
2017-12-30,2256,2604554,0,22,0,1360,joebiden
2017-12-31,2025,2606579,0,22,0,1360,joebiden
2018-01-01,1525,2608104,0,22,0,1360,joebiden
2018-01-02,1726,2609830,0,22,1,1361,joebiden
2018-01-03,2861,2612691,0,22,0,1361,joebiden
2018-01-04,3900,2616591,0,22,0,1361,joebiden
2018-01-05,4080,2620671,0,22,0,1361,joebiden
2018-01-06,2233,2622904,0,22,0,1361,joebiden
2018-01-07,2089,2624993,0,22,0,1361,joebiden
2018-01-08,2192,2627185,0,22,1,1362,joebiden
2018-01-09,2011,2629196,0,22,0,1362,joebiden
2018-01-10,1370,2630566,0,22,0,1362,joebiden
2018-01-11,1145,2631711,0,22,0,1362,joebiden
2018-01-12,3366,2635077,0,22,1,1363,joebiden
2018-01-13,12767,2647844,0,22,0,1363,joebiden
2018-01-14,3597,2651441,0,22,0,1363,joebiden
2018-01-15,1884,2653325,0,22,0,1363,joebiden
2018-01-16,2587,2655912,0,22,1,1364,joebiden
2018-01-17,1761,2657673,0,22,0,1364,joebiden
2018-01-18,1628,2659301,0,22,0,1364,joebiden
2018-01-19,1822,2661123,0,22,0,1364,joebiden
2018-01-20,216,2661339,0,22,0,1364,joebiden
2018-01-21,1000,2662339,0,22,0,1364,joebiden
2018-01-22,887,2663226,0,22,0,1364,joebiden
2018-01-23,738,2663964,0,22,1,1365,joebiden
2018-01-24,1309,2665273,0,22,0,1365,joebiden
2018-01-25,1375,2666648,0,22,0,1365,joebiden
2018-01-26,1453,2668101,0,22,0,1365,joebiden
2018-01-27,1172,2669273,0,22,0,1365,joebiden
2018-01-28,636,2669909,0,22,0,1365,joebiden
2018-01-29,524,2670433,0,22,0,1365,joebiden
2018-01-30,634,2671067,0,22,0,1365,joebiden
2018-01-31,2333,2673400,0,22,1,1366,joebiden
2018-02-01,1882,2675282,0,22,0,1366,joebiden
2018-02-02,1757,2677039,0,22,1,1367,joebiden
2018-02-03,940,2677979,0,22,0,1367,joebiden
2018-02-04,2002,2679981,0,22,0,1367,joebiden
2018-02-05,1718,2681699,0,22,2,1369,joebiden
2018-02-06,1266,2682965,0,22,0,1369,joebiden
2018-02-07,2163,2685128,0,22,0,1369,joebiden
2018-02-08,1717,2686845,0,22,0,1369,joebiden
2018-02-09,1963,2688808,0,22,2,1371,joebiden
2018-02-10,1305,2690113,0,22,1,1372,joebiden
2018-02-11,3091,2693204,0,22,0,1372,joebiden
2018-02-12,2379,2695583,0,22,0,1372,joebiden
2018-02-13,1338,2696921,0,22,0,1372,joebiden
2018-02-14,1768,2698689,0,22,2,1374,joebiden
2018-02-15,3428,2702117,0,22,1,1375,joebiden
2018-02-16,3340,2705457,0,22,0,1375,joebiden
2018-02-17,2007,2707464,0,22,0,1375,joebiden
2018-02-18,2159,2709623,0,22,0,1375,joebiden
2018-02-19,2091,2711714,0,22,0,1375,joebiden
2018-02-20,2517,2714231,0,22,0,1375,joebiden
2018-02-21,1690,2715921,0,22,0,1375,joebiden
2018-02-22,2446,2718367,0,22,1,1376,joebiden
2018-02-23,2743,2721110,0,22,1,1377,joebiden
2018-02-24,2015,2723125,0,22,0,1377,joebiden
2018-02-25,1850,2724975,0,22,0,1377,joebiden
2018-02-26,1885,2726860,0,22,0,1377,joebiden
2018-02-27,1670,2728530,0,22,1,1378,joebiden
2018-02-28,1587,2730117,0,22,0,1378,joebiden
2018-03-01,1698,2731815,0,22,1,1379,joebiden
2018-03-02,1516,2733331,0,22,0,1379,joebiden
2018-03-03,1429,2734760,0,22,0,1379,joebiden
2018-03-04,1410,2736170,0,22,0,1379,joebiden
2018-03-05,1452,2737622,0,22,0,1379,joebiden
2018-03-06,1341,2738963,0,22,0,1379,joebiden
2018-03-07,2289,2741252,0,22,1,1380,joebiden
2018-03-08,1588,2742840,0,22,0,1380,joebiden
2018-03-09,773,2743613,0,22,1,1381,joebiden
2018-03-10,863,2744476,0,22,0,1381,joebiden
2018-03-11,1161,2745637,0,22,0,1381,joebiden
2018-03-12,1059,2746696,0,22,0,1381,joebiden
2018-03-13,1616,2748312,0,22,1,1382,joebiden
2018-03-14,1335,2749647,0,22,1,1383,joebiden
2018-03-15,1306,2750953,0,22,0,1383,joebiden
2018-03-16,819,2751772,0,22,0,1383,joebiden
2018-03-17,963,2752735,0,22,2,1385,joebiden
2018-03-18,1052,2753787,0,22,0,1385,joebiden
2018-03-19,792,2754579,0,22,0,1385,joebiden
2018-03-20,872,2755451,0,22,1,1386,joebiden
2018-03-21,953,2756404,0,22,0,1386,joebiden
2018-03-22,9226,2765630,0,22,1,1387,joebiden
2018-03-23,13612,2779242,0,22,1,1388,joebiden
2018-03-24,6673,2785915,0,22,0,1388,joebiden
2018-03-25,3663,2789578,0,22,0,1388,joebiden
2018-03-26,2088,2791666,0,22,0,1388,joebiden
2018-03-27,1555,2793221,0,22,1,1389,joebiden
2018-03-28,869,2794090,0,22,2,1391,joebiden
2018-03-29,943,2795033,0,22,0,1391,joebiden
2018-03-30,720,2795753,0,22,0,1391,joebiden
2018-03-31,1053,2796806,0,22,0,1391,joebiden
2018-04-01,449,2797255,0,22,0,1391,joebiden
2018-04-02,807,2798062,0,22,0,1391,joebiden
2018-04-03,830,2798892,0,22,2,1393,joebiden
2018-04-04,512,2799404,0,22,1,1394,joebiden
2018-04-05,1055,2800459,0,22,0,1394,joebiden
2018-04-06,1203,2801662,0,22,1,1395,joebiden
2018-04-07,1356,2803018,0,22,0,1395,joebiden
2018-04-08,1435,2804453,0,22,0,1395,joebiden
2018-04-09,1510,2805963,0,22,0,1395,joebiden
2018-04-10,1664,2807627,0,22,0,1395,joebiden
2018-04-11,1642,2809269,0,22,0,1395,joebiden
2018-04-12,1689,2810958,0,22,0,1395,joebiden
2018-04-13,396,2811354,0,22,0,1395,joebiden
2018-04-14,975,2812329,0,22,0,1395,joebiden
2018-04-15,1325,2813654,0,22,0,1395,joebiden
2018-04-16,1647,2815301,0,22,1,1396,joebiden
2018-04-17,1453,2816754,0,22,0,1396,joebiden
2018-04-18,1583,2818337,0,22,1,1397,joebiden
2018-04-19,983,2819320,0,22,1,1398,joebiden
2018-04-20,446,2819766,0,22,2,1400,joebiden
2018-04-21,411,2820177,0,22,0,1400,joebiden
2018-04-22,377,2820554,0,22,0,1400,joebiden
2018-04-23,205,2820759,0,22,0,1400,joebiden
2018-04-24,1169,2821928,0,22,0,1400,joebiden
2018-04-25,509,2822437,0,22,0,1400,joebiden
2018-04-26,368,2822805,0,22,1,1401,joebiden
2018-04-27,221,2823026,0,22,0,1401,joebiden
2018-04-28,223,2823249,0,22,0,1401,joebiden
2018-04-29,76,2823325,0,22,0,1401,joebiden
2018-04-30,91,2823416,0,22,0,1401,joebiden
2018-05-01,346,2823762,0,22,0,1401,joebiden
2018-05-02,90,2823852,0,22,0,1401,joebiden
2018-05-03,443,2824295,0,22,0,1401,joebiden
2018-05-04,-213,2824082,0,22,0,1401,joebiden
2018-05-05,-58,2824024,0,22,1,1402,joebiden
2018-05-06,178,2824202,0,22,0,1402,joebiden
2018-05-07,141,2824343,0,22,0,1402,joebiden
2018-05-08,230,2824573,0,22,0,1402,joebiden
2018-05-09,1070,2825643,0,22,1,1403,joebiden
2018-05-10,459,2826102,0,22,0,1403,joebiden
2018-05-11,475,2826577,0,22,0,1403,joebiden
2018-05-12,1068,2827645,0,22,1,1404,joebiden
2018-05-13,934,2828579,0,22,0,1404,joebiden
2018-05-14,876,2829455,0,22,0,1404,joebiden
2018-05-15,455,2829910,0,22,1,1405,joebiden
2018-05-16,656,2830566,0,22,2,1407,joebiden
2018-05-17,343,2830909,0,22,1,1408,joebiden
2018-05-18,105,2831014,1,23,1,1409,joebiden
2018-05-19,1478,2832492,0,23,1,1410,joebiden
2018-05-20,716,2833208,0,23,0,1410,joebiden
2018-05-21,499,2833707,0,23,1,1411,joebiden
2018-05-22,269,2833976,0,23,0,1411,joebiden
2018-05-23,502,2834478,0,23,2,1413,joebiden
2018-05-24,642,2835120,0,23,0,1413,joebiden
2018-05-25,22,2835142,0,23,0,1413,joebiden
2018-05-26,535,2835677,0,23,1,1414,joebiden
2018-05-27,415,2836092,0,23,1,1415,joebiden
2018-05-28,515,2836607,0,23,1,1416,joebiden
2018-05-29,1191,2837798,0,23,1,1417,joebiden
2018-05-30,1413,2839211,0,23,0,1417,joebiden
2018-05-31,792,2840003,0,23,1,1418,joebiden
2018-06-01,991,2840994,0,23,1,1419,joebiden
2018-06-02,881,2841875,0,23,0,1419,joebiden
2018-06-03,679,2842554,0,23,0,1419,joebiden
2018-06-04,684,2843238,0,23,0,1419,joebiden
2018-06-05,747,2843985,0,23,0,1419,joebiden
2018-06-06,835,2844820,0,23,0,1419,joebiden
2018-06-07,789,2845609,0,23,1,1420,joebiden
2018-06-08,1205,2846814,0,23,2,1422,joebiden
2018-06-09,3147,2849961,0,23,3,1425,joebiden
2018-06-10,4469,2854430,0,23,1,1426,joebiden
2018-06-11,1696,2856126,0,23,0,1426,joebiden
2018-06-12,1565,2857691,0,23,1,1427,joebiden
2018-06-13,787,2858478,0,23,0,1427,joebiden
2018-06-14,727,2859205,0,23,0,1427,joebiden
2018-06-15,830,2860035,0,23,1,1428,joebiden
2018-06-16,753,2860788,0,23,1,1429,joebiden
2018-06-17,630,2861418,0,23,1,1430,joebiden
2018-06-18,722,2862140,0,23,0,1430,joebiden
2018-06-19,1628,2863768,0,23,0,1430,joebiden
2018-06-20,1343,2865111,0,23,0,1430,joebiden
2018-06-21,1269,2866380,0,23,1,1431,joebiden
2018-06-22,911,2867291,0,23,0,1431,joebiden
2018-06-23,656,2867947,0,23,0,1431,joebiden
2018-06-24,635,2868582,0,23,0,1431,joebiden
2018-06-25,653,2869235,0,23,0,1431,joebiden
2018-06-26,503,2869738,0,23,0,1431,joebiden
2018-06-27,359,2870097,0,23,2,1433,joebiden
2018-06-28,-63,2870034,0,23,5,1438,joebiden
2018-06-29,1690,2871724,0,23,2,1440,joebiden
2018-06-30,1671,2873395,0,23,0,1440,joebiden
2018-07-01,539,2873934,0,23,0,1440,joebiden
2018-07-02,390,2874324,0,23,0,1440,joebiden
2018-07-03,265,2874589,0,23,0,1440,joebiden
2018-07-04,256,2874845,0,23,0,1440,joebiden
2018-07-05,490,2875335,0,23,1,1441,joebiden
2018-07-06,481,2875816,0,23,1,1442,joebiden
2018-07-07,524,2876340,0,23,0,1442,joebiden
2018-07-08,366,2876706,0,23,0,1442,joebiden
2018-07-09,311,2877017,0,23,0,1442,joebiden
2018-07-10,-155,2876862,0,23,0,1442,joebiden
2018-07-11,-1843,2875019,0,23,0,1442,joebiden
2018-07-12,453,2875472,0,23,1,1443,joebiden
2018-07-13,-27562,2847910,0,23,0,1443,joebiden
2018-07-14,722,2848632,0,23,0,1443,joebiden
2018-07-15,677,2849309,0,23,0,1443,joebiden
2018-07-16,674,2849983,0,23,0,1443,joebiden
2018-07-17,2282,2852265,0,23,1,1444,joebiden
2018-07-18,631,2852896,0,23,0,1444,joebiden
2018-07-19,389,2853285,0,23,0,1444,joebiden
2018-07-20,832,2854117,0,23,0,1444,joebiden
2018-07-21,453,2854570,0,23,1,1445,joebiden
2018-07-22,530,2855100,0,23,0,1445,joebiden
2018-07-23,390,2855490,0,23,0,1445,joebiden
2018-07-24,468,2855958,0,23,0,1445,joebiden
2018-07-25,905,2856863,0,23,0,1445,joebiden
2018-07-26,1170,2858033,0,23,0,1445,joebiden
2018-07-27,1116,2859149,0,23,0,1445,joebiden
2018-07-28,768,2859917,0,23,1,1446,joebiden
2018-07-29,858,2860775,0,23,0,1446,joebiden
2018-07-30,793,2861568,0,23,0,1446,joebiden
2018-07-31,1546,2863114,0,23,0,1446,joebiden
2018-08-01,1547,2864661,0,23,-1,1445,joebiden
2018-08-02,2066,2866727,0,23,0,1445,joebiden
2018-08-03,1455,2868182,0,23,0,1445,joebiden
2018-08-04,5538,2873720,0,23,1,1446,joebiden
2018-08-05,16271,2889991,0,23,0,1446,joebiden
2018-08-06,3913,2893904,0,23,0,1446,joebiden
2018-08-07,1701,2895605,0,23,2,1448,joebiden
2018-08-08,1890,2897495,0,23,0,1448,joebiden
2018-08-09,1209,2898704,0,23,0,1448,joebiden
2018-08-10,1090,2899794,0,23,0,1448,joebiden
2018-08-11,905,2900699,0,23,0,1448,joebiden
2018-08-12,928,2901627,0,23,0,1448,joebiden
2018-08-13,2927,2904554,0,23,1,1449,joebiden
2018-08-14,1187,2905741,0,23,0,1449,joebiden
2018-08-15,1313,2907054,0,23,0,1449,joebiden
2018-08-16,3267,2910321,0,23,1,1450,joebiden
2018-08-17,2195,2912516,0,23,1,1451,joebiden
2018-08-18,724,2913240,0,23,1,1452,joebiden
2018-08-19,1780,2915020,0,23,1,1453,joebiden
2018-08-20,1122,2916142,0,23,1,1454,joebiden
2018-08-21,1253,2917395,0,23,0,1454,joebiden
2018-08-22,1509,2918904,0,23,0,1454,joebiden
2018-08-23,1380,2920284,0,23,0,1454,joebiden
2018-08-24,1249,2921533,0,23,0,1454,joebiden
2018-08-25,1645,2923178,0,23,1,1455,joebiden
2018-08-26,8114,2931292,0,23,1,1456,joebiden
2018-08-27,3250,2934542,0,23,0,1456,joebiden
2018-08-28,1315,2935857,0,23,0,1456,joebiden
2018-08-29,1599,2937456,0,23,0,1456,joebiden
2018-08-30,2190,2939646,0,23,1,1457,joebiden
2018-08-31,7016,2946662,0,23,0,1457,joebiden
2018-09-01,1788,2948450,0,23,1,1458,joebiden
2018-09-02,1900,2950350,0,23,0,1458,joebiden
2018-09-03,1252,2951602,0,23,0,1458,joebiden
2018-09-04,1338,2952940,0,23,0,1458,joebiden
2018-09-05,1488,2954428,0,23,0,1458,joebiden
2018-09-06,1841,2956269,0,23,2,1460,joebiden
2018-09-07,2341,2958610,0,23,0,1460,joebiden
2018-09-08,3919,2962529,0,23,1,1461,joebiden
2018-09-09,2958,2965487,0,23,0,1461,joebiden
2018-09-10,2491,2967978,0,23,0,1461,joebiden
2018-09-11,2292,2970270,0,23,1,1462,joebiden
2018-09-12,2735,2973005,0,23,1,1463,joebiden
2018-09-13,1988,2974993,0,23,0,1463,joebiden
2018-09-14,1836,2976829,0,23,1,1464,joebiden
2018-09-15,1720,2978549,0,23,0,1464,joebiden
2018-09-16,1833,2980382,0,23,0,1464,joebiden
2018-09-17,1528,2981910,0,23,0,1464,joebiden
2018-09-18,1674,2983584,0,23,0,1464,joebiden
2018-09-19,1579,2985163,0,23,0,1464,joebiden
2018-09-20,1327,2986490,0,23,0,1464,joebiden
2018-09-21,1434,2987924,0,23,5,1469,joebiden
2018-09-22,1474,2989398,0,23,0,1469,joebiden
2018-09-23,1263,2990661,0,23,0,1469,joebiden
2018-09-24,1145,2991806,0,23,1,1470,joebiden
2018-09-25,1053,2992859,0,23,0,1470,joebiden
2018-09-26,1287,2994146,0,23,1,1471,joebiden
2018-09-27,1379,2995525,0,23,0,1471,joebiden
2018-09-28,2556,2998081,0,23,0,1471,joebiden
2018-09-29,2032,3000113,0,23,0,1471,joebiden
2018-09-30,1588,3001701,0,23,0,1471,joebiden
2018-10-01,1456,3003157,0,23,1,1472,joebiden
2018-10-02,1565,3004722,0,23,0,1472,joebiden
2018-10-03,1907,3006629,0,23,1,1473,joebiden
2018-10-04,3468,3010097,0,23,0,1473,joebiden
2018-10-05,3126,3013223,0,23,0,1473,joebiden
2018-10-06,1715,3014938,0,23,0,1473,joebiden
2018-10-07,796,3015734,0,23,0,1473,joebiden
2018-10-08,2702,3018436,0,23,0,1473,joebiden
2018-10-09,491,3018927,0,23,1,1474,joebiden
2018-10-10,2376,3021303,0,23,0,1474,joebiden
2018-10-11,4725,3026028,0,23,0,1474,joebiden
2018-10-12,2440,3028468,0,23,0,1474,joebiden
2018-10-13,1501,3029969,0,23,1,1475,joebiden
2018-10-14,203,3030172,0,23,0,1475,joebiden
2018-10-15,1257,3031429,0,23,0,1475,joebiden
2018-10-16,1382,3032811,0,23,0,1475,joebiden
2018-10-17,513,3033324,0,23,0,1475,joebiden
2018-10-18,1013,3034337,0,23,1,1476,joebiden
2018-10-19,886,3035223,0,23,2,1478,joebiden
2018-10-20,950,3036173,0,23,0,1478,joebiden
2018-10-21,1051,3037224,0,23,0,1478,joebiden
2018-10-22,901,3038125,0,23,0,1478,joebiden
2018-10-23,1053,3039178,0,23,0,1478,joebiden
2018-10-24,1197,3040375,0,23,0,1478,joebiden
2018-10-25,5695,3046070,0,23,4,1482,joebiden
2018-10-26,2914,3048984,0,23,1,1483,joebiden
2018-10-27,3564,3052548,0,23,0,1483,joebiden
2018-10-28,1679,3054227,0,23,0,1483,joebiden
2018-10-29,1471,3055698,0,23,1,1484,joebiden
2018-10-30,1996,3057694,0,23,1,1485,joebiden
2018-10-31,2282,3059976,0,23,3,1488,joebiden
2018-11-01,2071,3062047,0,23,0,1488,joebiden
2018-11-02,1310,3063357,0,23,0,1488,joebiden
2018-11-03,1896,3065253,0,23,3,1491,joebiden
2018-11-04,1184,3066437,0,23,1,1492,joebiden
2018-11-05,1123,3067560,0,23,1,1493,joebiden
2018-11-06,2020,3069580,0,23,2,1495,joebiden
2018-11-07,2575,3072155,0,23,2,1497,joebiden
2018-11-08,2248,3074403,0,23,0,1497,joebiden
2018-11-09,-6265,3068138,0,23,0,1497,joebiden
2018-11-10,2989,3071127,0,23,1,1498,joebiden
2018-11-11,2332,3073459,0,23,0,1498,joebiden
2018-11-12,2753,3076212,0,23,2,1500,joebiden
2018-11-13,2439,3078651,0,23,1,1501,joebiden
2018-11-14,2844,3081495,0,23,0,1501,joebiden
2018-11-15,2476,3083971,0,23,1,1502,joebiden
2018-11-16,2318,3086289,0,23,1,1503,joebiden
2018-11-17,1471,3087760,0,23,1,1504,joebiden
2018-11-18,1544,3089304,0,23,0,1504,joebiden
2018-11-19,1802,3091106,0,23,0,1504,joebiden
2018-11-20,1755,3092861,0,23,0,1504,joebiden
2018-11-21,1768,3094629,0,23,0,1504,joebiden
2018-11-22,1636,3096265,0,23,1,1505,joebiden
2018-11-23,1531,3097796,0,23,0,1505,joebiden
2018-11-24,1507,3099303,0,23,0,1505,joebiden
2018-11-25,1421,3100724,0,23,0,1505,joebiden
2018-11-26,1437,3102161,0,23,0,1505,joebiden
2018-11-27,1252,3103413,0,23,0,1505,joebiden
2018-11-28,764,3104177,0,23,0,1505,joebiden
2018-12-01,4833,3109010,0,23,0,1505,joebiden
2018-12-02,1378,3110388,0,23,2,1507,joebiden
2018-12-03,1689,3112077,0,23,0,1507,joebiden
2018-12-04,1366,3113443,0,23,0,1507,joebiden
2018-12-05,2285,3115728,0,23,0,1507,joebiden
2018-12-06,1659,3117387,0,23,0,1507,joebiden
2018-12-07,1088,3118475,0,23,0,1507,joebiden
2018-12-08,1011,3119486,0,23,1,1508,joebiden
2018-12-09,1605,3121091,0,23,0,1508,joebiden
2018-12-10,1078,3122169,0,23,0,1508,joebiden
2018-12-11,374,3122543,0,23,0,1508,joebiden
2018-12-12,974,3123517,0,23,0,1508,joebiden
2018-12-13,1758,3125275,0,23,0,1508,joebiden
2018-12-14,1988,3127263,0,23,0,1508,joebiden
2018-12-15,3301,3130564,0,23,1,1509,joebiden
2018-12-16,3660,3134224,0,23,1,1510,joebiden
2018-12-17,2563,3136787,0,23,0,1510,joebiden
2018-12-18,2029,3138816,0,23,0,1510,joebiden
2018-12-19,1980,3140796,0,23,0,1510,joebiden
2018-12-20,2044,3142840,0,23,0,1510,joebiden
2018-12-21,2682,3145522,0,23,3,1513,joebiden
2018-12-22,2684,3148206,0,23,1,1514,joebiden
2018-12-23,2471,3150677,0,23,0,1514,joebiden
2018-12-24,2385,3153062,0,23,0,1514,joebiden
2018-12-25,2055,3155117,0,23,0,1514,joebiden
2018-12-26,2412,3157529,0,23,0,1514,joebiden
2018-12-27,2329,3159858,0,23,0,1514,joebiden
2018-12-28,2523,3162381,0,23,0,1514,joebiden
2018-12-29,2810,3165191,0,23,0,1514,joebiden
2018-12-30,3047,3168238,0,23,0,1514,joebiden
2018-12-31,2970,3171208,0,23,0,1514,joebiden
2019-01-01,2717,3173925,0,23,0,1514,joebiden
2019-01-02,3528,3177453,0,23,0,1514,joebiden
2019-01-03,3296,3180749,0,23,0,1514,joebiden
2019-01-04,3251,3184000,0,23,0,1514,joebiden
2019-01-05,3499,3187499,0,23,0,1514,joebiden
2019-01-06,3694,3191193,0,23,0,1514,joebiden
2019-01-07,4034,3195227,0,23,0,1514,joebiden
2019-01-08,2911,3198138,0,23,0,1514,joebiden
2019-01-09,3290,3201428,0,23,-1,1513,joebiden
2019-01-10,2978,3204406,0,23,0,1513,joebiden
2019-01-11,2491,3206897,0,23,0,1513,joebiden
2019-01-12,2482,3209379,0,23,1,1514,joebiden
2019-01-13,3449,3212828,0,23,0,1514,joebiden
2019-01-14,2944,3215772,0,23,0,1514,joebiden
2019-01-15,1643,3217415,0,23,0,1514,joebiden
2019-01-16,2761,3220176,0,23,0,1514,joebiden
2019-01-17,2499,3222675,0,23,2,1516,joebiden
2019-01-18,3335,3226010,0,23,1,1517,joebiden
2019-01-19,3359,3229369,0,23,0,1517,joebiden
2019-01-20,2522,3231891,0,23,0,1517,joebiden
2019-01-21,2463,3234354,0,23,0,1517,joebiden
2019-01-22,2718,3237072,0,23,1,1518,joebiden
2019-01-23,2361,3239433,0,23,2,1520,joebiden
2019-01-24,2922,3242355,0,23,0,1520,joebiden
2019-01-25,3347,3245702,0,23,0,1520,joebiden
2019-01-26,3407,3249109,0,23,0,1520,joebiden
2019-01-27,3590,3252699,0,23,2,1522,joebiden
2019-01-28,3798,3256497,0,23,0,1522,joebiden
2019-01-29,2519,3259016,0,23,0,1522,joebiden
2019-01-30,286,3259302,0,23,1,1523,joebiden
2019-01-31,2375,3261677,0,23,0,1523,joebiden
2019-02-01,1400,3263077,0,23,6,1529,joebiden
2019-02-02,1632,3264709,0,23,0,1529,joebiden
2019-02-03,2725,3267434,0,23,1,1530,joebiden
2019-02-04,2283,3269717,0,23,0,1530,joebiden
2019-02-05,1629,3271346,0,23,0,1530,joebiden
2019-02-06,2890,3274236,0,23,2,1532,joebiden
2019-02-07,3090,3277326,0,23,0,1532,joebiden
2019-02-10,6791,3284117,0,23,3,1535,joebiden
2019-02-11,4102,3288219,0,23,0,1535,joebiden
2019-02-12,2637,3290856,0,23,0,1535,joebiden
2019-02-13,2799,3293655,0,23,0,1535,joebiden
2019-02-14,2237,3295892,0,23,0,1535,joebiden
2019-02-15,2347,3298239,0,23,2,1537,joebiden
2019-02-16,3338,3301577,0,23,7,1544,joebiden
2019-02-17,2317,3303894,0,23,1,1545,joebiden
2019-02-18,2188,3306082,0,23,0,1545,joebiden
2019-02-19,2033,3308115,0,23,0,1545,joebiden
2019-02-20,2458,3310573,0,23,0,1545,joebiden
2019-02-21,2210,3312783,0,23,0,1545,joebiden
2019-02-22,2150,3314933,0,23,0,1545,joebiden
2019-02-23,2004,3316937,0,23,1,1546,joebiden
2019-02-24,2052,3318989,0,23,0,1546,joebiden
2019-02-25,1848,3320837,0,23,0,1546,joebiden
2019-02-26,1585,3322422,0,23,0,1546,joebiden
2019-02-27,2156,3324578,0,23,2,1548,joebiden
2019-02-28,3027,3327605,0,23,0,1548,joebiden
2019-03-01,2352,3329957,0,23,2,1550,joebiden
2019-03-02,2359,3332316,0,23,0,1550,joebiden
2019-03-03,2034,3334350,0,23,0,1550,joebiden
2019-03-04,1937,3336287,0,23,0,1550,joebiden
2019-03-05,1739,3338026,0,23,0,1550,joebiden
2019-03-06,1726,3339752,0,23,0,1550,joebiden
2019-03-07,1744,3341496,0,23,0,1550,joebiden
2019-03-08,1238,3342734,0,23,1,1551,joebiden
2019-03-09,605,3343339,0,23,1,1552,joebiden
2019-03-10,902,3344241,0,23,0,1552,joebiden
2019-03-11,969,3345210,0,23,0,1552,joebiden
2019-03-12,1558,3346768,0,23,2,1554,joebiden
2019-03-13,3968,3350736,0,23,0,1554,joebiden
2019-03-14,2749,3353485,0,23,2,1556,joebiden
2019-03-15,2458,3355943,0,23,0,1556,joebiden
2019-03-16,1961,3357904,0,23,3,1559,joebiden
2019-03-17,1525,3359429,0,23,2,1561,joebiden
2019-03-18,1776,3361205,0,23,0,1561,joebiden
2019-03-19,2182,3363387,0,23,0,1561,joebiden
2019-03-20,1677,3365064,0,23,0,1561,joebiden
2019-03-21,2088,3367152,0,23,0,1561,joebiden
2019-03-22,1913,3369065,0,23,0,1561,joebiden
2019-03-23,2039,3371104,0,23,0,1561,joebiden
2019-03-24,2434,3373538,0,23,0,1561,joebiden
2019-03-25,2614,3376152,0,23,1,1562,joebiden
2019-03-26,2023,3378175,0,23,0,1562,joebiden
2019-03-27,1658,3379833,0,23,2,1564,joebiden
2019-03-28,1528,3381361,0,23,0,1564,joebiden
2019-03-29,1799,3383160,0,23,2,1566,joebiden
2019-03-30,1740,3384900,0,23,1,1567,joebiden
2019-03-31,1738,3386638,0,23,0,1567,joebiden
2019-04-01,1834,3388472,0,23,0,1567,joebiden
2019-04-02,1947,3390419,0,23,0,1567,joebiden
2019-04-03,2281,3392700,0,23,0,1567,joebiden
2019-04-04,8902,3401602,0,23,1,1568,joebiden
2019-04-05,11560,3413162,-2,21,1,1569,joebiden
2019-04-06,10473,3423635,0,21,0,1569,joebiden
2019-04-07,3485,3427120,0,21,1,1570,joebiden
2019-04-08,2432,3429552,0,21,0,1570,joebiden
2019-04-09,1829,3431381,0,21,0,1570,joebiden
2019-04-10,1642,3433023,0,21,0,1570,joebiden
2019-04-11,1889,3434912,0,21,0,1570,joebiden
2019-04-12,2050,3436962,0,21,0,1570,joebiden
2019-04-13,1766,3438728,0,21,1,1571,joebiden
2019-04-14,2408,3441136,0,21,1,1572,joebiden
2019-04-15,2873,3444009,0,21,0,1572,joebiden
2019-04-16,3041,3447050,0,21,1,1573,joebiden
2019-04-17,2563,3449613,0,21,0,1573,joebiden
2019-04-18,2050,3451663,0,21,0,1573,joebiden
2019-04-19,2196,3453859,0,21,3,1576,joebiden
2019-04-20,2622,3456481,0,21,0,1576,joebiden
2019-04-21,2081,3458562,0,21,0,1576,joebiden
2019-04-22,2012,3460574,0,21,0,1576,joebiden
2019-04-23,1690,3462264,0,21,0,1576,joebiden
2019-04-24,1771,3464035,0,21,0,1576,joebiden
2019-04-25,1924,3465959,0,21,0,1576,joebiden
2019-04-26,55308,3521267,0,21,6,1582,joebiden
2019-04-27,9241,3530508,0,21,8,1590,joebiden
2019-04-28,4158,3534666,0,21,2,1592,joebiden
2019-04-29,2265,3536931,0,21,5,1597,joebiden
2019-04-30,8334,3545265,0,21,18,1615,joebiden
2019-05-01,7111,3552376,0,21,9,1624,joebiden
2019-05-02,3037,3555413,0,21,4,1628,joebiden
2019-05-03,1836,3557249,0,21,3,1631,joebiden
2019-05-04,697,3557946,0,21,2,1633,joebiden
2019-05-05,-1,3557945,0,21,3,1636,joebiden
2019-05-06,164,3558109,0,21,5,1641,joebiden
2019-05-07,441,3558550,0,21,4,1645,joebiden
2019-05-08,424,3558974,0,21,3,1648,joebiden
2019-05-09,237,3559211,0,21,4,1652,joebiden
2019-05-10,777,3559988,0,21,3,1655,joebiden
2019-05-11,879,3560867,0,21,4,1659,joebiden
2019-05-12,854,3561721,0,21,1,1660,joebiden
2019-05-14,2085,3563806,0,21,6,1666,joebiden
2019-05-15,795,3564601,0,21,2,1668,joebiden
2019-05-16,1926,3566527,0,21,3,1671,joebiden
2019-05-17,1090,3567617,0,21,3,1674,joebiden
2019-05-18,718,3568335,0,21,3,1677,joebiden
2019-05-19,426,3568761,1,22,19,1696,joebiden
2019-05-20,1794,3570555,0,22,0,1696,joebiden
2019-05-21,1878,3572433,0,22,0,1696,joebiden
2019-05-22,1448,3573881,0,22,8,1704,joebiden
2019-05-23,1675,3575556,0,22,2,1706,joebiden
2019-05-24,1259,3576815,0,22,4,1710,joebiden
2019-05-25,959,3577774,0,22,2,1712,joebiden
2019-05-26,893,3578667,0,22,3,1715,joebiden
2019-05-27,891,3579558,0,22,2,1717,joebiden
2019-05-28,1234,3580792,0,22,1,1718,joebiden
2019-05-29,1056,3581848,0,22,10,1728,joebiden
2019-05-30,1240,3583088,0,22,4,1732,joebiden
2019-05-31,1209,3584297,0,22,5,1737,joebiden
2019-06-01,811,3585108,0,22,4,1741,joebiden
2019-06-02,758,3585866,0,22,4,1745,joebiden
2019-06-03,799,3586665,0,22,1,1746,joebiden
2019-06-04,823,3587488,0,22,3,1749,joebiden
2019-06-05,502,3587990,0,22,13,1762,joebiden
2019-06-06,745,3588735,0,22,5,1767,joebiden
2019-06-07,186,3588921,0,22,6,1773,joebiden
2019-06-08,282,3589203,0,22,9,1782,joebiden
2019-06-09,370,3589573,0,22,6,1788,joebiden
2019-06-10,1612,3591185,0,22,2,1790,joebiden
2019-06-11,794,3591979,0,22,3,1793,joebiden
2019-06-12,787,3592766,0,22,12,1805,joebiden
2019-06-13,2560,3595326,0,22,6,1811,joebiden
