Date,Daily Followers Gained,Total Follower Count,Daily Followed Users,Total Followed Users,Daily Tweets Posted,Total Tweets Posted,Name
2016-08-16,771,679993,0,297,1,1590,ewarren
2016-08-17,920,680913,0,297,1,1591,ewarren
2016-08-18,696,681609,0,297,0,1591,ewarren
2016-08-19,669,682278,0,297,0,1591,ewarren
2016-08-20,586,682864,0,297,0,1591,ewarren
2016-08-21,533,683397,0,297,0,1591,ewarren
2016-08-22,644,684041,0,297,0,1591,ewarren
2016-08-23,734,684775,0,297,0,1591,ewarren
2016-08-24,672,685447,0,297,0,1591,ewarren
2016-08-25,671,686118,0,297,4,1595,ewarren
2016-08-26,597,686715,0,297,0,1595,ewarren
2016-08-27,479,687194,0,297,3,1598,ewarren
2016-08-28,275,687469,0,297,3,1601,ewarren
2016-08-29,509,687978,0,297,0,1601,ewarren
2016-08-30,507,688485,0,297,0,1601,ewarren
2016-08-31,240,688725,0,297,0,1601,ewarren
2016-09-01,1307,690032,0,297,0,1601,ewarren
2016-09-02,657,690689,0,297,0,1601,ewarren
2016-09-03,610,691299,0,297,0,1601,ewarren
2016-09-04,471,691770,0,297,0,1601,ewarren
2016-09-05,464,692234,0,297,1,1602,ewarren
2016-09-06,435,692669,0,297,0,1602,ewarren
2016-09-07,552,693221,0,297,0,1602,ewarren
2016-09-08,779,694000,0,297,0,1602,ewarren
2016-09-09,711,694711,0,297,2,1604,ewarren
2016-09-10,573,695284,0,297,1,1605,ewarren
2016-09-11,658,695942,0,297,0,1605,ewarren
2016-09-12,551,696493,0,297,1,1606,ewarren
2016-09-13,869,697362,0,297,0,1606,ewarren
2016-09-14,796,698158,0,297,0,1606,ewarren
2016-09-15,631,698789,0,297,0,1606,ewarren
2016-09-16,1115,699904,0,297,2,1608,ewarren
2016-09-17,1546,701450,0,297,2,1610,ewarren
2016-09-18,1114,702564,0,297,1,1611,ewarren
2016-09-19,859,703423,0,297,4,1615,ewarren
2016-09-20,1297,704720,0,297,0,1615,ewarren
2016-09-21,1808,706528,0,297,3,1618,ewarren
2016-09-22,1067,707595,0,297,0,1618,ewarren
2016-09-23,824,708419,0,297,0,1618,ewarren
2016-09-24,734,709153,0,297,3,1621,ewarren
2016-09-25,818,709971,0,297,0,1621,ewarren
2016-09-26,1426,711397,0,297,0,1621,ewarren
2016-09-27,8151,719548,0,297,5,1626,ewarren
2016-09-28,2234,721782,0,297,0,1626,ewarren
2016-09-29,1324,723106,0,297,0,1626,ewarren
2016-09-30,2033,725139,0,297,5,1631,ewarren
2016-10-01,7493,732632,0,297,0,1631,ewarren
2016-10-02,2321,734953,0,297,1,1632,ewarren
2016-10-03,1322,736275,0,297,0,1632,ewarren
2016-10-04,2385,738660,0,297,6,1638,ewarren
2016-10-05,3833,742493,0,297,0,1638,ewarren
2016-10-06,1161,743654,0,297,0,1638,ewarren
2016-10-07,1090,744744,0,297,4,1642,ewarren
2016-10-08,4342,749086,0,297,4,1646,ewarren
2016-10-09,3533,752619,0,297,0,1646,ewarren
2016-10-10,10249,762868,0,297,5,1651,ewarren
2016-10-11,3042,765910,0,297,1,1652,ewarren
2016-10-12,2207,768117,0,297,1,1653,ewarren
2016-10-13,2196,770313,0,297,0,1653,ewarren
2016-10-14,1839,772152,0,297,3,1656,ewarren
2016-10-15,1195,773347,0,297,0,1656,ewarren
2016-10-16,1541,774888,0,297,0,1656,ewarren
2016-10-17,1824,776712,0,297,1,1657,ewarren
2016-10-18,1731,778443,0,297,0,1657,ewarren
2016-10-19,5233,783676,0,297,9,1666,ewarren
2016-10-20,9090,792766,0,297,1,1667,ewarren
2016-10-21,1864,794630,0,297,0,1667,ewarren
2016-10-22,1620,796250,0,297,1,1668,ewarren
2016-10-23,1307,797557,0,297,1,1669,ewarren
2016-10-24,2211,799768,0,297,3,1672,ewarren
2016-10-25,1772,801540,0,297,0,1672,ewarren
2016-10-26,1732,803272,0,297,2,1674,ewarren
2016-10-27,1217,804489,0,297,0,1674,ewarren
2016-10-28,1215,805704,0,297,0,1674,ewarren
2016-10-29,1034,806738,0,297,0,1674,ewarren
2016-10-30,1079,807817,0,297,0,1674,ewarren
2016-10-31,1066,808883,0,297,0,1674,ewarren
2016-11-01,1243,810126,0,297,0,1674,ewarren
2016-11-02,1194,811320,0,297,1,1675,ewarren
2016-11-03,1210,812530,0,297,1,1676,ewarren
2016-11-04,957,813487,1,298,2,1678,ewarren
2016-11-05,1133,814620,0,298,2,1680,ewarren
2016-11-06,1562,816182,0,298,0,1680,ewarren
2016-11-07,1777,817959,0,298,1,1681,ewarren
2016-11-08,4039,821998,0,298,9,1690,ewarren
2016-11-09,10445,832443,0,298,0,1690,ewarren
2016-11-10,8436,840879,0,298,1,1691,ewarren
2016-11-11,12407,853286,0,298,2,1693,ewarren
2016-11-12,5427,858713,0,298,0,1693,ewarren
2016-11-13,5145,863858,0,298,0,1693,ewarren
2016-11-14,4236,868094,0,298,0,1693,ewarren
2016-11-15,4291,872385,0,298,0,1693,ewarren
2016-11-16,4324,876709,0,298,0,1693,ewarren
2016-11-17,3195,879904,0,298,0,1693,ewarren
2016-11-18,2594,882498,0,298,0,1693,ewarren
2016-11-19,3631,886129,0,298,0,1693,ewarren
2016-11-20,3751,889880,0,298,0,1693,ewarren
2016-11-21,2967,892847,0,298,0,1693,ewarren
2016-11-22,2677,895524,0,298,0,1693,ewarren
2016-11-23,2140,897664,0,298,0,1693,ewarren
2016-11-24,1621,899285,0,298,0,1693,ewarren
2016-11-25,1548,900833,0,298,0,1693,ewarren
2016-11-26,1620,902453,0,298,0,1693,ewarren
2016-11-27,2275,904728,0,298,0,1693,ewarren
2016-11-28,2170,906898,0,298,0,1693,ewarren
2016-11-29,2458,909356,0,298,0,1693,ewarren
2016-11-30,2100,911456,0,298,0,1693,ewarren
2016-12-01,1630,913086,0,298,0,1693,ewarren
2016-12-02,2232,915318,0,298,0,1693,ewarren
2016-12-03,1835,917153,0,298,0,1693,ewarren
2016-12-04,2470,919623,0,298,0,1693,ewarren
2016-12-05,1501,921124,0,298,0,1693,ewarren
2016-12-06,2050,923174,0,298,1,1694,ewarren
2016-12-07,1445,924619,0,298,0,1694,ewarren
2016-12-08,1082,925701,0,298,0,1694,ewarren
2016-12-09,1681,927382,0,298,1,1695,ewarren
2016-12-10,1314,928696,0,298,0,1695,ewarren
2016-12-11,1317,930013,0,298,0,1695,ewarren
2016-12-12,1143,931156,0,298,0,1695,ewarren
2016-12-13,1289,932445,0,298,0,1695,ewarren
2016-12-14,852,933297,0,298,0,1695,ewarren
2016-12-15,1383,934680,0,298,0,1695,ewarren
2016-12-16,1110,935790,0,298,0,1695,ewarren
2016-12-17,1165,936955,0,298,0,1695,ewarren
2016-12-18,1122,938077,0,298,0,1695,ewarren
2016-12-19,1295,939372,0,298,0,1695,ewarren
2016-12-20,1136,940508,0,298,0,1695,ewarren
2016-12-21,967,941475,0,298,2,1697,ewarren
2016-12-22,1007,942482,0,298,0,1697,ewarren
2016-12-23,1343,943825,0,298,0,1697,ewarren
2016-12-24,867,944692,0,298,1,1698,ewarren
2016-12-25,880,945572,0,298,0,1698,ewarren
2016-12-26,1029,946601,0,298,0,1698,ewarren
2016-12-27,1260,947861,0,298,0,1698,ewarren
2016-12-28,1678,949539,0,298,0,1698,ewarren
2016-12-29,1095,950634,0,298,0,1698,ewarren
2016-12-30,1206,951840,0,298,0,1698,ewarren
2016-12-31,1420,953260,0,298,0,1698,ewarren
2017-01-01,591,953851,0,298,0,1698,ewarren
2017-01-02,2130,955981,0,298,0,1698,ewarren
2017-01-03,2862,958843,0,298,0,1698,ewarren
2017-01-04,1085,959928,0,298,0,1698,ewarren
2017-01-05,3773,963701,0,298,0,1698,ewarren
2017-01-06,2615,966316,0,298,0,1698,ewarren
2017-01-07,2368,968684,0,298,0,1698,ewarren
2017-01-08,2381,971065,0,298,0,1698,ewarren
2017-01-09,2437,973502,0,298,0,1698,ewarren
2017-01-10,3913,977415,0,298,0,1698,ewarren
2017-01-11,6335,983750,0,298,1,1699,ewarren
2017-01-12,1298,985048,0,298,0,1699,ewarren
2017-01-13,5541,990589,0,298,0,1699,ewarren
2017-01-14,1718,992307,0,298,0,1699,ewarren
2017-01-15,5315,997622,0,298,3,1702,ewarren
2017-01-16,2632,1000254,0,298,0,1702,ewarren
2017-01-17,3271,1003525,0,298,0,1702,ewarren
2017-01-18,5949,1009474,0,298,0,1702,ewarren
2017-01-19,5401,1014875,0,298,-1,1701,ewarren
2017-01-20,10910,1025785,0,298,1,1702,ewarren
2017-01-21,18798,1044583,1,299,1,1703,ewarren
2017-01-22,12718,1057301,0,299,0,1703,ewarren
2017-01-23,13073,1070374,0,299,1,1704,ewarren
2017-01-24,9220,1079594,0,299,0,1704,ewarren
2017-01-25,10515,1090109,0,299,0,1704,ewarren
2017-01-26,12414,1102523,0,299,0,1704,ewarren
2017-01-27,9935,1112458,0,299,0,1704,ewarren
2017-01-28,7386,1119844,0,299,0,1704,ewarren
2017-01-29,16625,1136469,0,299,0,1704,ewarren
2017-01-30,15152,1151621,0,299,0,1704,ewarren
2017-01-31,12243,1163864,0,299,0,1704,ewarren
2017-02-01,8332,1172196,0,299,0,1704,ewarren
2017-02-02,7197,1179393,0,299,0,1704,ewarren
2017-02-03,6039,1185432,0,299,0,1704,ewarren
2017-02-04,6448,1191880,0,299,0,1704,ewarren
2017-02-05,6700,1198580,0,299,3,1707,ewarren
2017-02-06,5877,1204457,0,299,1,1708,ewarren
2017-02-07,5720,1210177,0,299,0,1708,ewarren
2017-02-08,17946,1228123,0,299,0,1708,ewarren
2017-02-09,22011,1250134,0,299,1,1709,ewarren
2017-02-10,14659,1264793,0,299,0,1709,ewarren
2017-02-11,7272,1272065,0,299,0,1709,ewarren
2017-02-12,6375,1278440,0,299,0,1709,ewarren
2017-02-13,7197,1285637,0,299,0,1709,ewarren
2017-02-14,3830,1289467,0,299,0,1709,ewarren
2017-02-15,5608,1295075,0,299,0,1709,ewarren
2017-02-16,4180,1299255,0,299,0,1709,ewarren
2017-02-17,3915,1303170,0,299,1,1710,ewarren
2017-02-18,3067,1306237,0,299,0,1710,ewarren
2017-02-19,2821,1309058,0,299,0,1710,ewarren
2017-02-20,2901,1311959,0,299,0,1710,ewarren
2017-02-21,2721,1314680,0,299,0,1710,ewarren
2017-02-22,2345,1317025,0,299,0,1710,ewarren
2017-02-23,2348,1319373,0,299,0,1710,ewarren
2017-02-24,2364,1321737,0,299,0,1710,ewarren
2017-02-25,2454,1324191,0,299,0,1710,ewarren
2017-02-26,6231,1330422,0,299,0,1710,ewarren
2017-02-27,3317,1333739,0,299,0,1710,ewarren
2017-02-28,2595,1336334,0,299,0,1710,ewarren
2017-03-01,3710,1340044,0,299,0,1710,ewarren
2017-03-02,2872,1342916,0,299,0,1710,ewarren
2017-03-03,2888,1345804,0,299,0,1710,ewarren
2017-03-04,2952,1348756,0,299,0,1710,ewarren
2017-03-05,2974,1351730,0,299,0,1710,ewarren
2017-03-06,2460,1354190,0,299,0,1710,ewarren
2017-03-07,2311,1356501,0,299,0,1710,ewarren
2017-03-08,2284,1358785,0,299,0,1710,ewarren
2017-03-09,2580,1361365,0,299,0,1710,ewarren
2017-03-10,2116,1363481,0,299,0,1710,ewarren
2017-03-11,1765,1365246,0,299,0,1710,ewarren
2017-03-12,1592,1366838,0,299,0,1710,ewarren
2017-03-13,1837,1368675,0,299,0,1710,ewarren
2017-03-14,2079,1370754,0,299,0,1710,ewarren
2017-03-15,2332,1373086,0,299,0,1710,ewarren
2017-03-16,2059,1375145,0,299,3,1713,ewarren
2017-03-17,2288,1377433,0,299,0,1713,ewarren
2017-03-18,1985,1379418,0,299,0,1713,ewarren
2017-03-19,1892,1381310,0,299,0,1713,ewarren
2017-03-20,1886,1383196,0,299,0,1713,ewarren
2017-03-21,2381,1385577,0,299,0,1713,ewarren
2017-03-22,1861,1387438,0,299,2,1715,ewarren
2017-03-23,1459,1388897,0,299,1,1716,ewarren
2017-03-24,2119,1391016,0,299,1,1717,ewarren
2017-03-25,3576,1394592,0,299,0,1717,ewarren
2017-03-26,2058,1396650,0,299,0,1717,ewarren
2017-03-27,1547,1398197,0,299,0,1717,ewarren
2017-03-28,1582,1399779,0,299,0,1717,ewarren
2017-03-29,1808,1401587,0,299,0,1717,ewarren
2017-03-30,1793,1403380,0,299,0,1717,ewarren
2017-03-31,1335,1404715,0,299,0,1717,ewarren
2017-04-01,1493,1406208,0,299,3,1720,ewarren
2017-04-02,1325,1407533,0,299,0,1720,ewarren
2017-04-03,1199,1408732,0,299,0,1720,ewarren
2017-04-04,1272,1410004,0,299,0,1720,ewarren
2017-04-05,1377,1411381,0,299,0,1720,ewarren
2017-04-06,956,1412337,0,299,0,1720,ewarren
2017-04-07,1558,1413895,0,299,0,1720,ewarren
2017-04-08,1122,1415017,0,299,0,1720,ewarren
2017-04-09,923,1415940,0,299,0,1720,ewarren
2017-04-10,761,1416701,0,299,0,1720,ewarren
2017-04-11,932,1417633,0,299,0,1720,ewarren
2017-04-12,921,1418554,0,299,4,1724,ewarren
2017-04-13,542,1419096,0,299,0,1724,ewarren
2017-04-14,541,1419637,0,299,0,1724,ewarren
2017-04-15,888,1420525,0,299,3,1727,ewarren
2017-04-16,848,1421373,0,299,0,1727,ewarren
2017-04-17,867,1422240,0,299,1,1728,ewarren
2017-04-18,775,1423015,0,299,8,1736,ewarren
2017-04-19,1620,1424635,0,299,5,1741,ewarren
2017-04-20,1534,1426169,0,299,2,1743,ewarren
2017-04-21,592,1426761,0,299,2,1745,ewarren
2017-04-22,1114,1427875,0,299,1,1746,ewarren
2017-04-23,1057,1428932,0,299,5,1751,ewarren
2017-04-24,928,1429860,0,299,1,1752,ewarren
2017-04-25,937,1430797,0,299,2,1754,ewarren
2017-04-26,854,1431651,0,299,0,1754,ewarren
2017-04-27,698,1432349,0,299,0,1754,ewarren
2017-04-28,849,1433198,0,299,7,1761,ewarren
2017-04-29,1226,1434424,0,299,3,1764,ewarren
2017-04-30,788,1435212,0,299,0,1764,ewarren
2017-05-01,1168,1436380,0,299,0,1764,ewarren
2017-05-02,1243,1437623,0,299,0,1764,ewarren
2017-05-03,1469,1439092,0,299,0,1764,ewarren
2017-05-04,1719,1440811,0,299,0,1764,ewarren
2017-05-05,3248,1444059,0,299,0,1764,ewarren
2017-05-06,1966,1446025,0,299,0,1764,ewarren
2017-05-07,1668,1447693,0,299,0,1764,ewarren
2017-05-08,2195,1449888,0,299,1,1765,ewarren
2017-05-09,1821,1451709,0,299,0,1765,ewarren
2017-05-10,3273,1454982,0,299,0,1765,ewarren
2017-05-11,2522,1457504,0,299,0,1765,ewarren
2017-05-12,2373,1459877,0,299,0,1765,ewarren
2017-05-13,2082,1461959,0,299,0,1765,ewarren
2017-05-14,1771,1463730,0,299,0,1765,ewarren
2017-05-15,1821,1465551,0,299,0,1765,ewarren
2017-05-16,2385,1467936,0,299,1,1766,ewarren
2017-05-17,2643,1470579,0,299,0,1766,ewarren
2017-05-18,2304,1472883,0,299,2,1768,ewarren
2017-05-19,3235,1476118,0,299,0,1768,ewarren
2017-05-20,569,1476687,0,299,0,1768,ewarren
2017-05-21,822,1477509,0,299,0,1768,ewarren
2017-05-22,575,1478084,0,299,0,1768,ewarren
2017-05-23,915,1478999,0,299,0,1768,ewarren
2017-05-24,1485,1480484,0,299,0,1768,ewarren
2017-05-25,1642,1482126,0,299,1,1769,ewarren
2017-05-26,1840,1483966,0,299,0,1769,ewarren
2017-05-27,1203,1485169,0,299,1,1770,ewarren
2017-05-28,1250,1486419,0,299,0,1770,ewarren
2017-05-29,1531,1487950,0,299,2,1772,ewarren
2017-05-30,1611,1489561,0,299,0,1772,ewarren
2017-05-31,2273,1491834,0,299,1,1773,ewarren
2017-06-01,2442,1494276,0,299,2,1775,ewarren
2017-06-02,2838,1497114,0,299,2,1777,ewarren
2017-06-03,1669,1498783,0,299,1,1778,ewarren
2017-06-04,1673,1500456,0,299,2,1780,ewarren
2017-06-05,1673,1502129,0,299,0,1780,ewarren
2017-06-06,1489,1503618,0,299,0,1780,ewarren
2017-06-07,1456,1505074,0,299,0,1780,ewarren
2017-06-08,2294,1507368,0,299,0,1780,ewarren
2017-06-09,2639,1510007,0,299,0,1780,ewarren
2017-06-10,1468,1511475,0,299,0,1780,ewarren
2017-06-11,1396,1512871,0,299,6,1786,ewarren
2017-06-12,1643,1514514,0,299,0,1786,ewarren
2017-06-13,1872,1516386,0,299,0,1786,ewarren
2017-06-14,4304,1520690,0,299,2,1788,ewarren
2017-06-15,2752,1523442,0,299,0,1788,ewarren
2017-06-16,1264,1524706,0,299,1,1789,ewarren
2017-06-17,2497,1527203,0,299,0,1789,ewarren
2017-06-18,2197,1529400,0,299,0,1789,ewarren
2017-06-19,2078,1531478,0,299,0,1789,ewarren
2017-06-20,2603,1534081,0,299,0,1789,ewarren
2017-06-21,2706,1536787,0,299,1,1790,ewarren
2017-06-22,2313,1539100,0,299,0,1790,ewarren
2017-06-23,3447,1542547,0,299,1,1791,ewarren
2017-06-24,2789,1545336,0,299,0,1791,ewarren
2017-06-25,2703,1548039,0,299,0,1791,ewarren
2017-06-26,2683,1550722,0,299,0,1791,ewarren
2017-06-27,2793,1553515,0,299,0,1791,ewarren
2017-06-28,2850,1556365,0,299,0,1791,ewarren
2017-06-29,2654,1559019,0,299,0,1791,ewarren
2017-06-30,3284,1562303,0,299,1,1792,ewarren
2017-07-01,2253,1564556,0,299,0,1792,ewarren
2017-07-02,1990,1566546,0,299,0,1792,ewarren
2017-07-03,2250,1568796,0,299,0,1792,ewarren
2017-07-04,2154,1570950,0,299,0,1792,ewarren
2017-07-05,2269,1573219,0,299,0,1792,ewarren
2017-07-06,3662,1576881,0,299,0,1792,ewarren
2017-07-07,3489,1580370,0,299,0,1792,ewarren
2017-07-08,3452,1583822,0,299,1,1793,ewarren
2017-07-09,2589,1586411,0,299,2,1795,ewarren
2017-07-10,2442,1588853,0,299,0,1795,ewarren
2017-07-11,2964,1591817,0,299,0,1795,ewarren
2017-07-12,3000,1594817,0,299,-1,1794,ewarren
2017-07-13,3459,1598276,0,299,2,1796,ewarren
2017-07-14,2527,1600803,0,299,0,1796,ewarren
2017-07-15,2174,1602977,0,299,0,1796,ewarren
2017-07-16,1849,1604826,0,299,0,1796,ewarren
2017-07-17,1907,1606733,0,299,0,1796,ewarren
2017-07-18,2120,1608853,0,299,0,1796,ewarren
2017-07-19,2177,1611030,0,299,0,1796,ewarren
2017-07-20,2038,1613068,0,299,0,1796,ewarren
2017-07-21,1575,1614643,0,299,1,1797,ewarren
2017-07-22,1384,1616027,0,299,0,1797,ewarren
2017-07-23,1192,1617219,0,299,0,1797,ewarren
2017-07-24,1138,1618357,0,299,1,1798,ewarren
2017-07-25,1415,1619772,0,299,0,1798,ewarren
2017-07-26,2146,1621918,0,299,1,1799,ewarren
2017-07-27,2651,1624569,0,299,0,1799,ewarren
2017-07-28,3313,1627882,0,299,0,1799,ewarren
2017-07-29,2234,1630116,0,299,0,1799,ewarren
2017-07-30,1785,1631901,0,299,0,1799,ewarren
2017-07-31,1578,1633479,0,299,0,1799,ewarren
2017-08-01,1600,1635079,0,299,0,1799,ewarren
2017-08-02,1616,1636695,0,299,0,1799,ewarren
2017-08-03,1266,1637961,0,299,0,1799,ewarren
2017-08-04,1258,1639219,0,299,0,1799,ewarren
2017-08-05,1172,1640391,0,299,0,1799,ewarren
2017-08-06,925,1641316,0,299,0,1799,ewarren
2017-08-07,930,1642246,0,299,0,1799,ewarren
2017-08-08,1196,1643442,0,299,8,1807,ewarren
2017-08-09,1872,1645314,0,299,0,1807,ewarren
2017-08-10,2070,1647384,0,299,0,1807,ewarren
2017-08-11,2621,1650005,0,299,0,1807,ewarren
2017-08-12,2300,1652305,0,299,1,1808,ewarren
2017-08-13,4690,1656995,0,299,0,1808,ewarren
2017-08-14,3957,1660952,0,299,0,1808,ewarren
2017-08-15,3279,1664231,0,299,0,1808,ewarren
2017-08-16,7174,1671405,0,299,3,1811,ewarren
2017-08-17,6007,1677412,0,299,0,1811,ewarren
2017-08-18,4689,1682101,0,299,0,1811,ewarren
2017-08-19,4066,1686167,0,299,0,1811,ewarren
2017-08-20,3438,1689605,0,299,0,1811,ewarren
2017-08-21,3355,1692960,0,299,0,1811,ewarren
2017-08-22,3122,1696082,0,299,0,1811,ewarren
2017-08-23,3480,1699562,0,299,0,1811,ewarren
2017-08-24,3277,1702839,0,299,0,1811,ewarren
2017-08-25,3844,1706683,0,299,0,1811,ewarren
2017-08-26,3239,1709922,0,299,0,1811,ewarren
2017-08-27,2943,1712865,0,299,0,1811,ewarren
2017-08-28,2489,1715354,0,299,0,1811,ewarren
2017-08-29,2210,1717564,0,299,2,1813,ewarren
2017-08-30,2299,1719863,0,299,0,1813,ewarren
2017-08-31,3006,1722869,0,299,0,1813,ewarren
2017-09-01,1632,1724501,0,299,0,1813,ewarren
2017-09-02,1014,1725515,0,299,0,1813,ewarren
2017-09-03,793,1726308,0,299,0,1813,ewarren
2017-09-04,988,1727296,0,299,0,1813,ewarren
2017-09-05,962,1728258,0,299,0,1813,ewarren
2017-09-06,1446,1729704,0,299,0,1813,ewarren
2017-09-07,1256,1730960,0,299,5,1818,ewarren
2017-09-08,1074,1732034,0,299,0,1818,ewarren
2017-09-09,874,1732908,0,299,0,1818,ewarren
2017-09-10,710,1733618,0,299,0,1818,ewarren
2017-09-11,1190,1734808,0,299,0,1818,ewarren
2017-09-12,2176,1736984,0,299,0,1818,ewarren
2017-09-13,1749,1738733,0,299,0,1818,ewarren
2017-09-14,2058,1740791,0,299,0,1818,ewarren
2017-09-15,2136,1742927,0,299,0,1818,ewarren
2017-09-16,2263,1745190,0,299,0,1818,ewarren
2017-09-17,2195,1747385,0,299,0,1818,ewarren
2017-09-18,1876,1749261,0,299,0,1818,ewarren
2017-09-19,1696,1750957,0,299,0,1818,ewarren
2017-09-20,1464,1752421,0,299,1,1819,ewarren
2017-09-21,2316,1754737,2,301,0,1819,ewarren
2017-09-22,1566,1756303,0,301,0,1819,ewarren
2017-09-23,1382,1757685,0,301,0,1819,ewarren
2017-09-24,1690,1759375,0,301,0,1819,ewarren
2017-09-25,1385,1760760,0,301,0,1819,ewarren
2017-09-26,1470,1762230,0,301,0,1819,ewarren
2017-09-27,1430,1763660,0,301,0,1819,ewarren
2017-09-28,1339,1764999,0,301,0,1819,ewarren
2017-09-29,862,1765861,0,301,0,1819,ewarren
2017-09-30,893,1766754,0,301,0,1819,ewarren
2017-10-01,1268,1768022,0,301,0,1819,ewarren
2017-10-02,1383,1769405,0,301,0,1819,ewarren
2017-10-03,1410,1770815,0,301,0,1819,ewarren
2017-10-04,1090,1771905,0,301,1,1820,ewarren
2017-10-05,131,1772036,0,301,0,1820,ewarren
2017-10-06,727,1772763,0,301,0,1820,ewarren
2017-10-07,847,1773610,0,301,0,1820,ewarren
2017-10-08,804,1774414,0,301,0,1820,ewarren
2017-10-09,985,1775399,0,301,0,1820,ewarren
2017-10-10,994,1776393,0,301,0,1820,ewarren
2017-10-11,887,1777280,0,301,0,1820,ewarren
2017-10-12,993,1778273,0,301,0,1820,ewarren
2017-10-13,784,1779057,0,301,0,1820,ewarren
2017-10-14,781,1779838,0,301,0,1820,ewarren
2017-10-15,642,1780480,0,301,0,1820,ewarren
2017-10-16,690,1781170,0,301,0,1820,ewarren
2017-10-17,817,1781987,0,301,0,1820,ewarren
2017-10-18,759,1782746,0,301,-1,1819,ewarren
2017-10-19,1174,1783920,0,301,0,1819,ewarren
2017-10-20,1192,1785112,0,301,0,1819,ewarren
2017-10-21,1141,1786253,0,301,0,1819,ewarren
2017-10-22,1043,1787296,0,301,0,1819,ewarren
2017-10-23,1002,1788298,0,301,0,1819,ewarren
2017-10-24,1311,1789609,0,301,0,1819,ewarren
2017-10-25,1911,1791520,0,301,0,1819,ewarren
2017-10-26,-1139,1790381,0,301,0,1819,ewarren
2017-10-27,622,1791003,0,301,0,1819,ewarren
2017-10-28,502,1791505,0,301,0,1819,ewarren
2017-10-29,569,1792074,0,301,0,1819,ewarren
2017-10-30,848,1792922,0,301,0,1819,ewarren
2017-10-31,1673,1794595,0,301,0,1819,ewarren
2017-11-01,1061,1795656,0,301,1,1820,ewarren
2017-11-02,2802,1798458,0,301,0,1820,ewarren
2017-11-03,211,1798669,0,301,0,1820,ewarren
2017-11-04,4192,1802861,0,301,4,1824,ewarren
2017-11-05,1449,1804310,0,301,0,1824,ewarren
2017-11-06,2395,1806705,0,301,0,1824,ewarren
2017-11-07,2739,1809444,0,301,2,1826,ewarren
2017-11-08,2879,1812323,0,301,2,1828,ewarren
2017-11-09,2282,1814605,0,301,0,1828,ewarren
2017-11-10,797,1815402,0,301,0,1828,ewarren
2017-11-11,1354,1816756,0,301,0,1828,ewarren
2017-11-12,1548,1818304,0,301,0,1828,ewarren
2017-11-13,1478,1819782,0,301,1,1829,ewarren
2017-11-14,1629,1821411,0,301,0,1829,ewarren
2017-11-15,1560,1822971,0,301,1,1830,ewarren
2017-11-16,2205,1825176,0,301,0,1830,ewarren
2017-11-17,1707,1826883,0,301,0,1830,ewarren
2017-11-18,1511,1828394,0,301,0,1830,ewarren
2017-11-19,1499,1829893,0,301,0,1830,ewarren
2017-11-20,1717,1831610,0,301,0,1830,ewarren
2017-11-21,2092,1833702,0,301,4,1834,ewarren
2017-11-22,2389,1836091,0,301,0,1834,ewarren
2017-11-23,1641,1837732,0,301,0,1834,ewarren
2017-11-24,1348,1839080,0,301,0,1834,ewarren
2017-11-25,1813,1840893,0,301,0,1834,ewarren
2017-11-26,1511,1842404,0,301,0,1834,ewarren
2017-11-27,1631,1844035,0,301,0,1834,ewarren
2017-11-28,2787,1846822,0,301,0,1834,ewarren
2017-11-29,2693,1849515,0,301,0,1834,ewarren
2017-11-30,2117,1851632,0,301,1,1835,ewarren
2017-12-01,1828,1853460,0,301,0,1835,ewarren
2017-12-02,3405,1856865,0,301,0,1835,ewarren
2017-12-03,4121,1860986,0,301,0,1835,ewarren
2017-12-04,2077,1863063,0,301,0,1835,ewarren
2017-12-05,1934,1864997,0,301,0,1835,ewarren
2017-12-06,2053,1867050,0,301,0,1835,ewarren
2017-12-07,1604,1868654,0,301,0,1835,ewarren
2017-12-08,1355,1870009,0,301,0,1835,ewarren
2017-12-09,678,1870687,0,301,0,1835,ewarren
2017-12-10,1205,1871892,0,301,0,1835,ewarren
2017-12-11,849,1872741,0,301,0,1835,ewarren
2017-12-12,929,1873670,0,301,0,1835,ewarren
2017-12-13,4621,1878291,0,301,5,1840,ewarren
2017-12-14,3641,1881932,0,301,0,1840,ewarren
2017-12-15,708,1882640,0,301,0,1840,ewarren
2017-12-16,1904,1884544,0,301,2,1842,ewarren
2017-12-17,518,1885062,0,301,0,1842,ewarren
2017-12-18,1155,1886217,0,301,0,1842,ewarren
2017-12-19,1263,1887480,0,301,0,1842,ewarren
2017-12-20,1451,1888931,0,301,0,1842,ewarren
2017-12-21,1736,1890667,0,301,0,1842,ewarren
2017-12-22,2002,1892669,0,301,0,1842,ewarren
2017-12-23,1690,1894359,0,301,0,1842,ewarren
2017-12-24,1546,1895905,0,301,0,1842,ewarren
2017-12-25,1437,1897342,0,301,0,1842,ewarren
2017-12-26,1676,1899018,0,301,0,1842,ewarren
2017-12-27,1967,1900985,0,301,0,1842,ewarren
2017-12-28,2844,1903829,0,301,0,1842,ewarren
2017-12-29,2996,1906825,0,301,2,1844,ewarren
2017-12-30,2194,1909019,0,301,0,1844,ewarren
2017-12-31,1676,1910695,0,301,2,1846,ewarren
2018-01-01,1484,1912179,0,301,0,1846,ewarren
2018-01-02,1679,1913858,0,301,1,1847,ewarren
2018-01-03,2497,1916355,0,301,0,1847,ewarren
2018-01-04,3145,1919500,0,301,0,1847,ewarren
2018-01-05,3529,1923029,0,301,0,1847,ewarren
2018-01-06,2101,1925130,0,301,0,1847,ewarren
2018-01-07,1965,1927095,0,301,1,1848,ewarren
2018-01-08,2181,1929276,0,301,0,1848,ewarren
2018-01-09,2141,1931417,0,301,0,1848,ewarren
2018-01-10,2307,1933724,0,301,0,1848,ewarren
2018-01-11,2450,1936174,0,301,0,1848,ewarren
2018-01-12,3259,1939433,0,301,0,1848,ewarren
2018-01-13,2225,1941658,0,301,0,1848,ewarren
2018-01-14,1837,1943495,0,301,0,1848,ewarren
2018-01-15,1467,1944962,0,301,0,1848,ewarren
2018-01-16,1531,1946493,0,301,1,1849,ewarren
2018-01-17,1291,1947784,0,301,0,1849,ewarren
2018-01-18,888,1948672,0,301,0,1849,ewarren
2018-01-19,1459,1950131,0,301,0,1849,ewarren
2018-01-20,-728,1949403,0,301,0,1849,ewarren
2018-01-21,705,1950108,0,301,0,1849,ewarren
2018-01-22,346,1950454,0,301,1,1850,ewarren
2018-01-23,-74,1950380,0,301,0,1850,ewarren
2018-01-24,181,1950561,0,301,0,1850,ewarren
2018-01-25,283,1950844,0,301,0,1850,ewarren
2018-01-26,345,1951189,0,301,0,1850,ewarren
2018-01-27,138,1951327,0,301,0,1850,ewarren
2018-01-28,-14,1951313,0,301,0,1850,ewarren
2018-01-29,-172,1951141,0,301,1,1851,ewarren
2018-01-30,67,1951208,0,301,0,1851,ewarren
2018-01-31,1929,1953137,0,301,9,1860,ewarren
2018-02-01,1442,1954579,0,301,3,1863,ewarren
2018-02-02,1279,1955858,0,301,0,1863,ewarren
2018-02-03,1015,1956873,0,301,0,1863,ewarren
2018-02-04,1503,1958376,0,301,0,1863,ewarren
2018-02-05,1557,1959933,0,301,1,1864,ewarren
2018-02-06,1471,1961404,0,301,1,1865,ewarren
2018-02-07,1441,1962845,0,301,1,1866,ewarren
2018-02-08,1358,1964203,0,301,0,1866,ewarren
2018-02-09,1773,1965976,0,301,0,1866,ewarren
2018-02-10,1672,1967648,0,301,0,1866,ewarren
2018-02-11,1933,1969581,0,301,1,1867,ewarren
2018-02-12,1972,1971553,0,301,0,1867,ewarren
2018-02-13,1481,1973034,0,301,1,1868,ewarren
2018-02-14,1828,1974862,0,301,5,1873,ewarren
2018-02-15,2775,1977637,0,301,1,1874,ewarren
2018-02-16,1816,1979453,0,301,0,1874,ewarren
2018-02-17,939,1980392,0,301,2,1876,ewarren
2018-02-18,983,1981375,0,301,0,1876,ewarren
2018-02-19,1016,1982391,0,301,0,1876,ewarren
2018-02-20,1209,1983600,0,301,0,1876,ewarren
2018-02-21,1073,1984673,0,301,0,1876,ewarren
2018-02-22,1496,1986169,0,301,1,1877,ewarren
2018-02-23,1396,1987565,0,301,7,1884,ewarren
2018-02-24,1221,1988786,0,301,0,1884,ewarren
2018-02-25,1786,1990572,0,301,0,1884,ewarren
2018-02-26,1902,1992474,-1,300,1,1885,ewarren
2018-02-27,1947,1994421,0,300,0,1885,ewarren
2018-02-28,1622,1996043,0,300,0,1885,ewarren
2018-03-01,2090,1998133,0,300,0,1885,ewarren
2018-03-02,2057,2000190,0,300,2,1887,ewarren
2018-03-03,1589,2001779,0,300,4,1891,ewarren
2018-03-04,2223,2004002,0,300,0,1891,ewarren
2018-03-05,1500,2005502,0,300,0,1891,ewarren
2018-03-06,1347,2006849,0,300,0,1891,ewarren
2018-03-07,1555,2008404,0,300,1,1892,ewarren
2018-03-08,1142,2009546,0,300,3,1895,ewarren
2018-03-09,836,2010382,0,300,0,1895,ewarren
2018-03-10,673,2011055,0,300,1,1896,ewarren
2018-03-11,820,2011875,0,300,4,1900,ewarren
2018-03-12,775,2012650,0,300,5,1905,ewarren
2018-03-13,1186,2013836,0,300,2,1907,ewarren
2018-03-14,1084,2014920,0,300,1,1908,ewarren
2018-03-15,309,2015229,0,300,1,1909,ewarren
2018-03-16,122,2015351,0,300,0,1909,ewarren
2018-03-17,579,2015930,0,300,0,1909,ewarren
2018-03-18,653,2016583,0,300,0,1909,ewarren
2018-03-19,517,2017100,0,300,1,1910,ewarren
2018-03-20,601,2017701,0,300,0,1910,ewarren
2018-03-21,766,2018467,0,300,0,1910,ewarren
2018-03-22,1082,2019549,0,300,0,1910,ewarren
2018-03-23,1499,2021048,0,300,0,1910,ewarren
2018-03-24,986,2022034,0,300,11,1921,ewarren
2018-03-25,1029,2023063,0,300,4,1925,ewarren
2018-03-26,1052,2024115,0,300,1,1926,ewarren
2018-03-27,957,2025072,0,300,0,1926,ewarren
2018-03-28,364,2025436,0,300,0,1926,ewarren
2018-03-29,1033,2026469,0,300,0,1926,ewarren
2018-03-30,1379,2027848,0,300,0,1926,ewarren
2018-03-31,1095,2028943,0,300,0,1926,ewarren
2018-04-01,767,2029710,0,300,0,1926,ewarren
2018-04-02,766,2030476,0,300,-1,1925,ewarren
2018-04-03,374,2030850,0,300,5,1930,ewarren
2018-04-04,26,2030876,0,300,0,1930,ewarren
2018-04-05,414,2031290,0,300,6,1936,ewarren
2018-04-06,445,2031735,0,300,1,1937,ewarren
2018-04-07,831,2032566,-1,299,0,1937,ewarren
2018-04-08,781,2033347,0,299,1,1938,ewarren
2018-04-09,754,2034101,0,299,0,1938,ewarren
2018-04-10,963,2035064,0,299,0,1938,ewarren
2018-04-11,797,2035861,0,299,0,1938,ewarren
2018-04-12,675,2036536,0,299,0,1938,ewarren
2018-04-13,76,2036612,0,299,3,1941,ewarren
2018-04-14,379,2036991,1,300,4,1945,ewarren
2018-04-15,404,2037395,0,300,1,1946,ewarren
2018-04-16,382,2037777,0,300,2,1948,ewarren
2018-04-17,395,2038172,0,300,0,1948,ewarren
2018-04-18,-28,2038144,0,300,0,1948,ewarren
2018-04-19,239,2038383,0,300,0,1948,ewarren
2018-04-20,167,2038550,0,300,2,1950,ewarren
2018-04-21,34,2038584,0,300,1,1951,ewarren
2018-04-22,-51,2038533,0,300,11,1962,ewarren
2018-04-23,44,2038577,0,300,0,1962,ewarren
2018-04-24,542,2039119,0,300,0,1962,ewarren
2018-04-25,156,2039275,0,300,0,1962,ewarren
2018-04-26,-23,2039252,0,300,1,1963,ewarren
2018-04-27,-46,2039206,0,300,0,1963,ewarren
2018-04-28,77,2039283,0,300,0,1963,ewarren
2018-04-29,-53,2039230,0,300,1,1964,ewarren
2018-04-30,-114,2039116,0,300,1,1965,ewarren
2018-05-01,223,2039339,0,300,1,1966,ewarren
2018-05-02,-135,2039204,0,300,3,1969,ewarren
2018-05-03,187,2039391,0,300,1,1970,ewarren
2018-05-04,-286,2039105,0,300,0,1970,ewarren
2018-05-05,-199,2038906,0,300,0,1970,ewarren
2018-05-06,-18,2038888,0,300,0,1970,ewarren
2018-05-07,9,2038897,0,300,0,1970,ewarren
2018-05-08,155,2039052,0,300,0,1970,ewarren
2018-05-09,202,2039254,0,300,1,1971,ewarren
2018-05-10,161,2039415,0,300,3,1974,ewarren
2018-05-11,473,2039888,0,300,0,1974,ewarren
2018-05-12,322,2040210,0,300,0,1974,ewarren
2018-05-13,553,2040763,0,300,0,1974,ewarren
2018-05-14,551,2041314,0,300,0,1974,ewarren
2018-05-15,331,2041645,0,300,2,1976,ewarren
2018-05-16,396,2042041,0,300,7,1983,ewarren
2018-05-17,215,2042256,0,300,0,1983,ewarren
2018-05-18,96,2042352,0,300,0,1983,ewarren
2018-05-19,329,2042681,0,300,0,1983,ewarren
2018-05-20,164,2042845,0,300,1,1984,ewarren
2018-05-21,259,2043104,0,300,0,1984,ewarren
2018-05-22,120,2043224,0,300,0,1984,ewarren
2018-05-23,133,2043357,0,300,0,1984,ewarren
2018-05-24,-26,2043331,-1,299,2,1986,ewarren
2018-05-25,-77,2043254,0,299,1,1987,ewarren
2018-05-26,8,2043262,0,299,0,1987,ewarren
2018-05-27,38,2043300,0,299,0,1987,ewarren
2018-05-28,81,2043381,0,299,1,1988,ewarren
2018-05-29,12,2043393,0,299,1,1989,ewarren
2018-05-30,237,2043630,0,299,2,1991,ewarren
2018-05-31,-19,2043611,0,299,1,1992,ewarren
2018-06-01,189,2043800,0,299,1,1993,ewarren
2018-06-02,-17,2043783,0,299,15,2008,ewarren
2018-06-03,220,2044003,0,299,0,2008,ewarren
2018-06-04,132,2044135,0,299,1,2009,ewarren
2018-06-05,272,2044407,0,299,0,2009,ewarren
2018-06-06,190,2044597,0,299,2,2011,ewarren
2018-06-07,278,2044875,0,299,0,2011,ewarren
2018-06-08,829,2045704,0,299,0,2011,ewarren
2018-06-09,193,2045897,0,299,2,2013,ewarren
2018-06-10,253,2046150,0,299,8,2021,ewarren
2018-06-11,126,2046276,0,299,3,2024,ewarren
2018-06-12,229,2046505,0,299,0,2024,ewarren
2018-06-13,-60,2046445,0,299,3,2027,ewarren
2018-06-14,159,2046604,0,299,1,2028,ewarren
2018-06-15,324,2046928,0,299,2,2030,ewarren
2018-06-16,185,2047113,0,299,1,2031,ewarren
2018-06-17,138,2047251,0,299,0,2031,ewarren
2018-06-18,301,2047552,0,299,1,2032,ewarren
2018-06-19,455,2048007,0,299,0,2032,ewarren
2018-06-20,467,2048474,0,299,1,2033,ewarren
2018-06-21,609,2049083,0,299,3,2036,ewarren
2018-06-22,313,2049396,0,299,1,2037,ewarren
2018-06-23,215,2049611,0,299,3,2040,ewarren
2018-06-24,373,2049984,0,299,3,2043,ewarren
2018-06-25,476,2050460,0,299,3,2046,ewarren
2018-06-26,485,2050945,0,299,0,2046,ewarren
2018-06-27,441,2051386,0,299,4,2050,ewarren
2018-06-28,696,2052082,0,299,2,2052,ewarren
2018-06-29,499,2052581,0,299,2,2054,ewarren
2018-06-30,386,2052967,0,299,2,2056,ewarren
2018-07-01,400,2053367,0,299,6,2062,ewarren
2018-07-02,469,2053836,0,299,1,2063,ewarren
2018-07-03,904,2054740,0,299,0,2063,ewarren
2018-07-04,420,2055160,0,299,0,2063,ewarren
2018-07-05,419,2055579,0,299,0,2063,ewarren
2018-07-06,4320,2059899,0,299,1,2064,ewarren
2018-07-07,3866,2063765,0,299,1,2065,ewarren
2018-07-08,1531,2065296,0,299,0,2065,ewarren
2018-07-09,738,2066034,0,299,1,2066,ewarren
2018-07-10,-1008,2065026,0,299,3,2069,ewarren
2018-07-11,-693,2064333,0,299,2,2071,ewarren
2018-07-12,372,2064705,0,299,2,2073,ewarren
2018-07-13,-5974,2058731,0,299,0,2073,ewarren
2018-07-14,436,2059167,0,299,1,2074,ewarren
2018-07-15,523,2059690,0,299,0,2074,ewarren
2018-07-16,499,2060189,0,299,1,2075,ewarren
2018-07-17,1270,2061459,0,299,2,2077,ewarren
2018-07-18,580,2062039,0,299,0,2077,ewarren
2018-07-19,416,2062455,0,299,3,2080,ewarren
2018-07-20,544,2062999,0,299,2,2082,ewarren
2018-07-21,270,2063269,0,299,0,2082,ewarren
2018-07-22,317,2063586,0,299,0,2082,ewarren
2018-07-23,215,2063801,0,299,1,2083,ewarren
2018-07-24,109,2063910,0,299,2,2085,ewarren
2018-07-25,412,2064322,0,299,2,2087,ewarren
2018-07-26,423,2064745,0,299,1,2088,ewarren
2018-07-27,389,2065134,0,299,2,2090,ewarren
2018-07-28,288,2065422,0,299,3,2093,ewarren
2018-07-29,287,2065709,0,299,1,2094,ewarren
2018-07-30,288,2065997,0,299,1,2095,ewarren
2018-07-31,286,2066283,0,299,3,2098,ewarren
2018-08-01,266,2066549,0,299,0,2098,ewarren
2018-08-02,338,2066887,0,299,2,2100,ewarren
2018-08-03,323,2067210,0,299,2,2102,ewarren
2018-08-04,405,2067615,0,299,3,2105,ewarren
2018-08-05,588,2068203,0,299,1,2106,ewarren
2018-08-06,417,2068620,0,299,1,2107,ewarren
2018-08-07,285,2068905,0,299,3,2110,ewarren
2018-08-08,329,2069234,0,299,5,2115,ewarren
2018-08-09,174,2069408,0,299,2,2117,ewarren
2018-08-10,422,2069830,0,299,4,2121,ewarren
2018-08-11,361,2070191,0,299,2,2123,ewarren
2018-08-12,455,2070646,0,299,0,2123,ewarren
2018-08-13,-123,2070523,0,299,2,2125,ewarren
2018-08-14,293,2070816,0,299,1,2126,ewarren
2018-08-15,319,2071135,0,299,4,2130,ewarren
2018-08-16,140,2071275,0,299,3,2133,ewarren
2018-08-17,285,2071560,0,299,3,2136,ewarren
2018-08-18,119,2071679,0,299,1,2137,ewarren
2018-08-19,470,2072149,0,299,0,2137,ewarren
2018-08-20,276,2072425,0,299,0,2137,ewarren
2018-08-21,434,2072859,0,299,3,2140,ewarren
2018-08-22,1012,2073871,0,299,3,2143,ewarren
2018-08-23,815,2074686,0,299,3,2146,ewarren
2018-08-24,694,2075380,0,299,4,2150,ewarren
2018-08-25,463,2075843,0,299,5,2155,ewarren
2018-08-26,955,2076798,0,299,2,2157,ewarren
2018-08-27,663,2077461,0,299,0,2157,ewarren
2018-08-28,478,2077939,0,299,0,2157,ewarren
2018-08-29,608,2078547,0,299,2,2159,ewarren
2018-08-30,685,2079232,0,299,3,2162,ewarren
2018-08-31,502,2079734,0,299,0,2162,ewarren
2018-09-01,338,2080072,0,299,0,2162,ewarren
2018-09-02,388,2080460,0,299,1,2163,ewarren
2018-09-03,394,2080854,0,299,0,2163,ewarren
2018-09-04,332,2081186,0,299,5,2168,ewarren
2018-09-05,585,2081771,0,299,12,2180,ewarren
2018-09-06,771,2082542,0,299,3,2183,ewarren
2018-09-07,1584,2084126,0,299,8,2191,ewarren
2018-09-08,893,2085019,0,299,7,2198,ewarren
2018-09-09,779,2085798,0,299,5,2203,ewarren
2018-09-10,536,2086334,0,299,4,2207,ewarren
2018-09-11,451,2086785,0,299,4,2211,ewarren
2018-09-12,546,2087331,0,299,5,2216,ewarren
2018-09-13,486,2087817,0,299,6,2222,ewarren
2018-09-14,481,2088298,0,299,7,2229,ewarren
2018-09-15,310,2088608,0,299,2,2231,ewarren
2018-09-16,354,2088962,0,299,1,2232,ewarren
2018-09-17,276,2089238,0,299,3,2235,ewarren
2018-09-18,328,2089566,0,299,5,2240,ewarren
2018-09-19,321,2089887,0,299,5,2245,ewarren
2018-09-20,336,2090223,0,299,4,2249,ewarren
2018-09-21,313,2090536,0,299,4,2253,ewarren
2018-09-22,343,2090879,1,300,6,2259,ewarren
2018-09-23,349,2091228,0,300,6,2265,ewarren
2018-09-24,364,2091592,0,300,2,2267,ewarren
2018-09-25,320,2091912,0,300,4,2271,ewarren
2018-09-26,150,2092062,0,300,6,2277,ewarren
2018-09-27,413,2092475,0,300,1,2278,ewarren
2018-09-28,1643,2094118,0,300,2,2280,ewarren
2018-09-29,1304,2095422,0,300,4,2284,ewarren
2018-09-30,1319,2096741,0,300,2,2286,ewarren
2018-10-01,1076,2097817,0,300,3,2289,ewarren
2018-10-02,700,2098517,0,300,8,2297,ewarren
2018-10-03,654,2099171,0,300,6,2303,ewarren
2018-10-04,790,2099961,0,300,5,2308,ewarren
2018-10-05,1017,2100978,0,300,5,2313,ewarren
2018-10-06,1000,2101978,0,300,6,2319,ewarren
2018-10-07,992,2102970,0,300,9,2328,ewarren
2018-10-08,1877,2104847,0,300,5,2333,ewarren
2018-10-09,-1546,2103301,0,300,5,2338,ewarren
2018-10-10,193,2103494,0,300,6,2344,ewarren
2018-10-11,960,2104454,0,300,5,2349,ewarren
2018-10-12,752,2105206,0,300,14,2363,ewarren
2018-10-13,578,2105784,0,300,3,2366,ewarren
2018-10-14,141,2105925,0,300,3,2369,ewarren
2018-10-15,3118,2109043,0,300,11,2380,ewarren
2018-10-16,7792,2116835,0,300,32,2412,ewarren
2018-10-17,1148,2117983,0,300,9,2421,ewarren
2018-10-18,96,2118079,0,300,7,2428,ewarren
2018-10-19,-707,2117372,0,300,11,2439,ewarren
2018-10-20,39,2117411,0,300,16,2455,ewarren
2018-10-21,267,2117678,0,300,5,2460,ewarren
2018-10-22,28,2117706,0,300,12,2472,ewarren
2018-10-23,199,2117905,0,300,10,2482,ewarren
2018-10-24,268,2118173,0,300,8,2490,ewarren
2018-10-25,370,2118543,0,300,4,2494,ewarren
2018-10-26,295,2118838,0,300,6,2500,ewarren
2018-10-27,3187,2122025,0,300,5,2505,ewarren
2018-10-28,355,2122380,0,300,2,2507,ewarren
2018-10-29,180,2122560,0,300,10,2517,ewarren
2018-10-30,267,2122827,0,300,12,2529,ewarren
2018-10-31,272,2123099,0,300,19,2548,ewarren
2018-11-01,331,2123430,0,300,7,2555,ewarren
2018-11-02,206,2123636,0,300,10,2565,ewarren
2018-11-03,323,2123959,0,300,6,2571,ewarren
2018-11-04,-629,2123330,0,300,18,2589,ewarren
2018-11-05,-404,2122926,0,300,12,2601,ewarren
2018-11-06,365,2123291,0,300,13,2614,ewarren
2018-11-07,728,2124019,0,300,32,2646,ewarren
2018-11-08,1033,2125052,0,300,4,2650,ewarren
2018-11-09,-865,2124187,0,300,1,2651,ewarren
2018-11-10,966,2125153,0,300,0,2651,ewarren
2018-11-11,989,2126142,0,300,1,2652,ewarren
2018-11-12,645,2126787,0,300,1,2653,ewarren
2018-11-13,598,2127385,0,300,1,2654,ewarren
2018-11-14,856,2128241,0,300,1,2655,ewarren
2018-11-15,692,2128933,0,300,4,2659,ewarren
2018-11-16,712,2129645,0,300,3,2662,ewarren
2018-11-17,160,2129805,0,300,5,2667,ewarren
2018-11-18,597,2130402,0,300,1,2668,ewarren
2018-11-19,511,2130913,0,300,1,2669,ewarren
2018-11-20,609,2131522,0,300,1,2670,ewarren
2018-11-21,658,2132180,0,300,4,2674,ewarren
2018-11-22,688,2132868,0,300,2,2676,ewarren
2018-11-23,421,2133289,0,300,2,2678,ewarren
2018-11-24,469,2133758,0,300,1,2679,ewarren
2018-11-25,437,2134195,0,300,1,2680,ewarren
2018-11-26,351,2134546,0,300,4,2684,ewarren
2018-11-27,305,2134851,0,300,8,2692,ewarren
2018-11-28,224,2135075,0,300,5,2697,ewarren
2018-12-01,864,2135939,0,300,17,2714,ewarren
2018-12-02,395,2136334,0,300,0,2714,ewarren
2018-12-03,420,2136754,0,300,1,2715,ewarren
2018-12-04,332,2137086,0,300,5,2720,ewarren
2018-12-05,230,2137316,0,300,6,2726,ewarren
2018-12-06,258,2137574,0,300,0,2726,ewarren
2018-12-07,-123,2137451,0,300,6,2732,ewarren
2018-12-08,81,2137532,0,300,2,2734,ewarren
2018-12-09,423,2137955,0,300,4,2738,ewarren
2018-12-10,213,2138168,0,300,3,2741,ewarren
2018-12-11,47,2138215,0,300,6,2747,ewarren
2018-12-12,174,2138389,0,300,6,2753,ewarren
2018-12-13,91,2138480,0,300,5,2758,ewarren
2018-12-14,298,2138778,0,300,5,2763,ewarren
2018-12-15,176,2138954,0,300,5,2768,ewarren
2018-12-16,302,2139256,0,300,5,2773,ewarren
2018-12-17,213,2139469,0,300,2,2775,ewarren
2018-12-18,121,2139590,0,300,4,2779,ewarren
2018-12-19,166,2139756,0,300,5,2784,ewarren
2018-12-20,176,2139932,0,300,2,2786,ewarren
2018-12-21,94,2140026,0,300,7,2793,ewarren
2018-12-22,406,2140432,0,300,0,2793,ewarren
2018-12-23,487,2140919,0,300,3,2796,ewarren
2018-12-24,418,2141337,0,300,2,2798,ewarren
2018-12-25,387,2141724,0,300,1,2799,ewarren
2018-12-26,293,2142017,0,300,0,2799,ewarren
2018-12-27,254,2142271,0,300,0,2799,ewarren
2018-12-28,247,2142518,0,300,1,2800,ewarren
2018-12-29,396,2142914,0,300,2,2802,ewarren
2018-12-30,426,2143340,0,300,1,2803,ewarren
2018-12-31,493,2143833,0,300,1,2804,ewarren
2019-01-01,13167,2157000,0,300,7,2811,ewarren
2019-01-02,5895,2162895,0,300,2,2813,ewarren
2019-01-03,6017,2168912,0,300,9,2822,ewarren
2019-01-04,5622,2174534,0,300,3,2825,ewarren
2019-01-05,4696,2179230,0,300,5,2830,ewarren
2019-01-06,4431,2183661,0,300,4,2834,ewarren
2019-01-07,3777,2187438,0,300,3,2837,ewarren
2019-01-08,1694,2189132,0,300,4,2841,ewarren
2019-01-09,2073,2191205,0,300,5,2846,ewarren
2019-01-10,1859,2193064,0,300,5,2851,ewarren
2019-01-11,1468,2194532,0,300,5,2856,ewarren
2019-01-12,1783,2196315,0,300,5,2861,ewarren
2019-01-13,1930,2198245,0,300,3,2864,ewarren
2019-01-14,2043,2200288,0,300,3,2867,ewarren
2019-01-15,699,2200987,0,300,5,2872,ewarren
2019-01-16,1471,2202458,0,300,1,2873,ewarren
2019-01-17,1349,2203807,0,300,5,2878,ewarren
2019-01-18,1287,2205094,0,300,5,2883,ewarren
2019-01-19,2103,2207197,0,300,6,2889,ewarren
2019-01-20,1306,2208503,0,300,2,2891,ewarren
2019-01-21,1080,2209583,0,300,2,2893,ewarren
2019-01-22,1462,2211045,0,300,4,2897,ewarren
2019-01-23,1208,2212253,0,300,9,2906,ewarren
2019-01-24,1194,2213447,0,300,3,2909,ewarren
2019-01-25,2100,2215547,0,300,10,2919,ewarren
2019-01-26,2166,2217713,0,300,3,2922,ewarren
2019-01-27,1689,2219402,0,300,3,2925,ewarren
2019-01-28,1671,2221073,0,300,4,2929,ewarren
2019-01-29,1260,2222333,0,300,9,2938,ewarren
2019-01-30,878,2223211,0,300,8,2946,ewarren
2019-01-31,1100,2224311,0,300,5,2951,ewarren
2019-02-01,942,2225253,0,300,4,2955,ewarren
2019-02-02,1201,2226454,0,300,7,2962,ewarren
2019-02-03,936,2227390,0,300,2,2964,ewarren
2019-02-04,809,2228199,0,300,0,2964,ewarren
2019-02-05,483,2228682,0,300,8,2972,ewarren
2019-02-06,1423,2230105,0,300,12,2984,ewarren
2019-02-07,935,2231040,0,300,6,2990,ewarren
2019-02-10,4709,2235749,1,301,63,3053,ewarren
2019-02-11,3389,2239138,0,301,7,3060,ewarren
2019-02-12,1570,2240708,0,301,8,3068,ewarren
2019-02-13,1619,2242327,0,301,8,3076,ewarren
2019-02-14,1496,2243823,0,301,7,3083,ewarren
2019-02-15,1301,2245124,0,301,19,3102,ewarren
2019-02-16,2225,2247349,0,301,7,3109,ewarren
2019-02-17,1263,2248612,0,301,4,3113,ewarren
2019-02-18,1049,2249661,0,301,5,3118,ewarren
2019-02-19,773,2250434,1,302,8,3126,ewarren
2019-02-20,1854,2252288,0,302,15,3141,ewarren
2019-02-21,1804,2254092,0,302,12,3153,ewarren
2019-02-22,1511,2255603,0,302,8,3161,ewarren
2019-02-23,1403,2257006,0,302,7,3168,ewarren
2019-02-24,1039,2258045,0,302,6,3174,ewarren
2019-02-25,994,2259039,0,302,7,3181,ewarren
2019-02-26,1004,2260043,0,302,25,3206,ewarren
2019-02-27,1141,2261184,0,302,6,3212,ewarren
2019-02-28,1392,2262576,0,302,10,3222,ewarren
2019-03-01,1183,2263759,0,302,10,3232,ewarren
2019-03-02,1085,2264844,-1,301,8,3240,ewarren
2019-03-03,1180,2266024,0,301,4,3244,ewarren
2019-03-04,1326,2267350,0,301,8,3252,ewarren
2019-03-05,1005,2268355,0,301,12,3264,ewarren
2019-03-06,891,2269246,1,302,10,3274,ewarren
2019-03-07,837,2270083,1,303,8,3282,ewarren
2019-03-08,944,2271027,0,303,10,3292,ewarren
2019-03-09,1724,2272751,1,304,21,3313,ewarren
2019-03-10,1373,2274124,0,304,8,3321,ewarren
2019-03-11,1400,2275524,0,304,8,3329,ewarren
2019-03-12,1813,2277337,0,304,10,3339,ewarren
2019-03-13,1495,2278832,0,304,10,3349,ewarren
2019-03-14,1662,2280494,0,304,8,3357,ewarren
2019-03-15,2211,2282705,0,304,6,3363,ewarren
2019-03-16,2291,2284996,0,304,2,3365,ewarren
2019-03-17,2521,2287517,0,304,11,3376,ewarren
2019-03-18,2813,2290330,0,304,3,3379,ewarren
2019-03-19,3169,2293499,0,304,37,3416,ewarren
2019-03-20,4608,2298107,0,304,10,3426,ewarren
2019-03-21,3329,2301436,0,304,15,3441,ewarren
2019-03-22,2903,2304339,0,304,12,3453,ewarren
2019-03-23,2962,2307301,0,304,11,3464,ewarren
2019-03-24,3771,2311072,0,304,9,3473,ewarren
2019-03-25,3131,2314203,0,304,7,3480,ewarren
2019-03-26,2071,2316274,1,305,15,3495,ewarren
2019-03-27,1730,2318004,1,306,9,3504,ewarren
2019-03-28,2103,2320107,4,310,14,3518,ewarren
2019-03-29,3127,2323234,-1,309,14,3532,ewarren
2019-03-30,2352,2325586,1,310,12,3544,ewarren
2019-03-31,1852,2327438,0,310,10,3554,ewarren
2019-04-01,2024,2329462,0,310,12,3566,ewarren
2019-04-02,1435,2330897,1,311,8,3574,ewarren
2019-04-03,1815,2332712,0,311,13,3587,ewarren
2019-04-04,2267,2334979,0,311,13,3600,ewarren
2019-04-05,1935,2336914,1,312,10,3610,ewarren
2019-04-06,2413,2339327,1,313,19,3629,ewarren
2019-04-07,1831,2341158,1,314,9,3638,ewarren
2019-04-08,1975,2343133,1,315,6,3644,ewarren
2019-04-09,1810,2344943,0,315,13,3657,ewarren
2019-04-10,1583,2346526,0,315,8,3665,ewarren
2019-04-11,1629,2348155,1,316,17,3682,ewarren
2019-04-12,2136,2350291,1,317,22,3704,ewarren
2019-04-13,3796,2354087,0,317,21,3725,ewarren
2019-04-14,3835,2357922,0,317,30,3755,ewarren
2019-04-15,3087,2361009,0,317,5,3760,ewarren
2019-04-16,2861,2363870,0,317,17,3777,ewarren
2019-04-17,2767,2366637,0,317,11,3788,ewarren
2019-04-18,3184,2369821,3,320,16,3804,ewarren
2019-04-19,3060,2372881,2,322,3,3807,ewarren
2019-04-20,8872,2381753,0,322,12,3819,ewarren
2019-04-21,5679,2387432,0,322,7,3826,ewarren
2019-04-22,3088,2390520,0,322,5,3831,ewarren
2019-04-23,14645,2405165,2,324,57,3888,ewarren
2019-04-24,13018,2418183,0,324,21,3909,ewarren
2019-04-25,6485,2424668,0,324,22,3931,ewarren
2019-04-26,6453,2431121,0,324,10,3941,ewarren
2019-04-27,5374,2436495,0,324,13,3954,ewarren
2019-04-28,5201,2441696,0,324,7,3961,ewarren
2019-04-29,3553,2445249,0,324,4,3965,ewarren
2019-04-30,3204,2448453,0,324,8,3973,ewarren
2019-05-01,3739,2452192,0,324,12,3985,ewarren
2019-05-02,5894,2458086,0,324,12,3997,ewarren
2019-05-03,3655,2461741,-1,323,19,4016,ewarren
2019-05-04,2673,2464414,0,323,15,4031,ewarren
2019-05-05,2667,2467081,1,324,14,4045,ewarren
2019-05-06,3180,2470261,0,324,5,4050,ewarren
2019-05-07,2015,2472276,0,324,8,4058,ewarren
2019-05-08,3196,2475472,0,324,5,4063,ewarren
2019-05-09,2958,2478430,0,324,18,4081,ewarren
2019-05-10,3018,2481448,0,324,14,4095,ewarren
2019-05-11,2497,2483945,0,324,17,4112,ewarren
2019-05-12,2687,2486632,0,324,5,4117,ewarren
2019-05-14,8064,2494696,0,324,33,4150,ewarren
2019-05-15,9349,2504045,0,324,9,4159,ewarren
2019-05-16,8402,2512447,2,326,20,4179,ewarren
2019-05-17,5464,2517911,0,326,15,4194,ewarren
2019-05-18,4643,2522554,0,326,24,4218,ewarren
2019-05-19,4253,2526807,1,327,5,4223,ewarren
2019-05-20,6825,2533632,0,327,4,4227,ewarren
2019-05-21,3762,2537394,0,327,17,4244,ewarren
2019-05-22,3009,2540403,0,327,15,4259,ewarren
2019-05-23,3230,2543633,0,327,16,4275,ewarren
2019-05-24,2898,2546531,1,328,12,4287,ewarren
2019-05-25,3704,2550235,0,328,8,4295,ewarren
2019-05-26,2629,2552864,0,328,11,4306,ewarren
2019-05-27,2290,2555154,0,328,6,4312,ewarren
2019-05-28,2137,2557291,0,328,6,4318,ewarren
2019-05-29,3375,2560666,0,328,9,4327,ewarren
2019-05-30,6287,2566953,0,328,15,4342,ewarren
2019-05-31,4300,2571253,0,328,18,4360,ewarren
2019-06-01,4394,2575647,1,329,21,4381,ewarren
2019-06-02,3526,2579173,0,329,21,4402,ewarren
2019-06-03,5242,2584415,1,330,10,4412,ewarren
2019-06-04,3199,2587614,1,331,6,4418,ewarren
2019-06-05,2440,2590054,0,331,20,4438,ewarren
2019-06-06,4769,2594823,2,333,33,4471,ewarren
2019-06-07,5000,2599823,1,334,10,4481,ewarren
2019-06-08,3365,2603188,0,334,7,4488,ewarren
2019-06-09,2907,2606095,0,334,3,4491,ewarren
2019-06-10,3279,2609374,0,334,5,4496,ewarren
2019-06-11,2855,2612229,0,334,8,4504,ewarren
2019-06-12,2561,2614790,0,334,10,4514,ewarren
2019-06-13,3776,2618566,0,334,8,4522,ewarren
